GEO_ID,CENSUS_TRACT,BOROUGH,CITY,PRECINCT,POP_AGE18_24,POP_AGE18_24_M,POP_AGE18_24_F,POP_25OVER,POP_25OVER_M,POP_25OVER_F,UNDERHS_AGE18to24,UNDERHS_AGE18to24_M,UNDERHS_AGE18to24_F,UNDER9th_25OVER,UNDER9th_25OVER_M,UNDER9th_25OVER_F,UNDERHS_25OVER,UNDERHS_25OVER_M,UNDERHS_25OVER_F
1400000US36061012900,Census Tract 129,Manhattan, New York,18,666,302,364,4258,2763,1495,17,8,0,200,61,81,153,75,79
1400000US36061015200,Census Tract 152,Manhattan, New York,19,485,126,359,5633,2419,3214,50,13,31,614,143,270,338,94,244
1400000US36005019400,Census Tract 194,Bronx, New York,45,75,42,33,1205,586,619,0,0,0,0,29,50,192,64,128
1400000US36061000202,Census Tract 2.02,Manhattan, New York,7,506,148,358,6283,3115,3168,159,46,82,2193,583,741,898,526,371
1400000US36061028700,Census Tract 287,Manhattan, New York,115,424,196,228,2900,1213,1687,108,50,84,458,58,299,392,221,170
1400000US36005029301,Census Tract 293.01,Bronx, New York,50,35,11,24,1436,685,751,0,0,0,0,0,9,26,9,17
1400000US36005030900,Census Tract 309,Bronx, New York,50,58,41,17,2593,1051,1542,0,0,0,0,30,32,150,45,106
1400000US36061003900,Census Tract 39,Manhattan, New York,1,142,91,51,3670,1764,1906,0,0,0,0,0,27,121,46,74
1400000US36005041400,Census Tract 414,Bronx, New York,47,469,253,216,3189,1390,1799,148,80,102,415,70,171,424,229,194
1400000US36061006200,Census Tract 62,Manhattan, New York,13,1027,386,641,2650,1264,1386,24,9,40,0,16,15,95,76,19
1400000US36047062800,Census Tract 628,Brooklyn, New York,61,567,242,325,3460,1662,1798,16,7,0,170,18,22,235,150,86
1400000US36061008601,Census Tract 86.01,Manhattan, New York,17,301,32,269,1844,982,862,0,0,0,0,5,0,9,0,9
1400000US36061008602,Census Tract 86.02,Manhattan, New York,17,0,0,0,0,0,0,0,0,0,0,0,0,0,0,0
1400000US36047990100,Census Tract 9901,Brooklyn, New York,0,0,0,0,0,0,0,0,0,0,0,0,0,0,0,0
1400000US36081990100,Census Tract 9901,Queens, New York,0,0,0,0,0,0,0,0,0,0,0,0,0,0,0,0
1400000US36085990100,Census Tract 9901,Staten Island, New York,0,0,0,0,0,0,0,0,0,0,0,0,0,0,0,0
1400000US36061000100,Census Tract 1,Manhattan, New York,1,0,0,0,0,0,0,0,0,0,0,0,0,0,0,0
1400000US36061001300,Census Tract 13,Manhattan, New York,1,502,123,379,3035,1597,1438,0,0,0,0,0,0,36,35,0
1400000US36061002100,Census Tract 21,Manhattan, New York,1,343,105,238,3662,1930,1732,4,1,0,62,27,24,26,0,24
1400000US36061003100,Census Tract 31,Manhattan, New York,1,1462,638,824,1208,468,740,18,8,0,25,44,87,120,49,71
1400000US36061003300,Census Tract 33,Manhattan, New York,1,257,127,130,3550,1779,1771,6,3,0,163,0,0,0,0,0
1400000US36061003700,Census Tract 37,Manhattan, New York,1,378,64,314,1644,781,863,16,3,0,84,9,34,44,22,22
1400000US36061004700,Census Tract 47,Manhattan, New York,1,153,69,84,1948,1060,888,14,6,0,325,0,0,162,69,93
1400000US36061004900,Census Tract 49,Manhattan, New York,1,440,178,262,3770,1969,1801,0,0,0,0,33,43,45,32,13
1400000US36061006900,Census Tract 69,Manhattan, New York,1,621,164,457,1743,962,781,18,5,50,0,0,9,0,0,0
1400000US36061031703,Census Tract 317.03,Manhattan, New York,1,103,57,46,5651,2519,3132,0,0,0,0,13,69,34,35,0
1400000US36061031704,Census Tract 317.04,Manhattan, New York,1,186,87,99,4407,2146,2261,0,0,0,0,62,29,48,49,0
1400000US36061031900,Census Tract 319,Manhattan, New York,1,0,0,0,0,0,0,0,0,0,0,0,0,0,0,0
1400000US36061001501,Census Tract 15.01,Manhattan, New York,5,555,295,260,4049,1738,2311,25,13,0,389,116,312,275,43,231
1400000US36061001600,Census Tract 16,Manhattan, New York,5,582,308,274,6228,3220,3008,62,33,55,0,989,1245,853,580,274
1400000US36061002500,Census Tract 25,Manhattan, New York,5,600,331,269,3446,1328,2118,123,68,74,410,449,765,593,206,385
1400000US36061002700,Census Tract 27,Manhattan, New York,5,126,57,69,981,396,585,0,0,0,0,96,116,101,36,65
1400000US36061002900,Census Tract 29,Manhattan, New York,5,702,531,171,5242,3014,2228,164,124,51,121,760,820,640,482,158
1400000US36061003001,Census Tract 30.01,Manhattan, New York,5,498,205,293,3791,2075,1716,18,7,23,27,158,269,49,0,51
1400000US36061003601,Census Tract 36.01,Manhattan, New York,5,513,224,289,2157,1145,1012,69,30,59,173,79,231,170,82,89
1400000US36061004100,Census Tract 41,Manhattan, New York,5,1099,424,675,5506,2418,3088,0,0,0,0,786,1062,374,133,238
1400000US36061004300,Census Tract 43,Manhattan, New York,5,404,238,166,3769,2177,1592,35,21,6,592,172,174,139,37,103
1400000US36061004500,Census Tract 45,Manhattan, New York,5,32,2,30,726,375,351,0,0,0,0,28,0,0,0,0
1400000US36061005501,Census Tract 55.01,Manhattan, New York,6,366,243,123,3424,1731,1693,29,19,15,0,0,0,17,0,15
1400000US36061005700,Census Tract 57,Manhattan, New York,6,195,124,71,2115,1062,1053,0,0,0,0,0,11,2,3,0
1400000US36061005900,Census Tract 59,Manhattan, New York,6,1170,435,735,3948,1756,2192,11,4,10,28,14,15,28,5,22
1400000US36061006300,Census Tract 63,Manhattan, New York,6,334,104,230,5203,2537,2666,26,8,31,271,0,0,57,41,19
1400000US36061006500,Census Tract 65,Manhattan, New York,6,1913,599,1314,4681,2480,2201,0,0,0,0,2,55,47,25,22
1400000US36061006700,Census Tract 67,Manhattan, New York,6,511,148,363,4553,2041,2512,0,0,0,0,12,0,96,14,83
1400000US36061007100,Census Tract 71,Manhattan, New York,6,397,153,244,4654,2445,2209,10,4,0,191,93,46,14,12,0
1400000US36061007300,Census Tract 73,Manhattan, New York,6,232,35,197,5286,2691,2595,19,3,107,0,13,0,42,30,13
1400000US36061007500,Census Tract 75,Manhattan, New York,6,167,1,166,3826,2089,1737,1,0,166,0,0,36,42,42,2
1400000US36061007700,Census Tract 77,Manhattan, New York,6,212,47,165,5003,2370,2633,0,0,0,0,0,13,195,107,87
1400000US36061007900,Census Tract 79,Manhattan, New York,6,182,65,117,3810,1693,2117,0,0,0,0,12,0,38,22,19
1400000US36061000201,Census Tract 2.01,Manhattan, New York,7,386,175,211,1866,773,1093,149,68,94,627,164,453,369,172,198
1400000US36061000600,Census Tract 6,Manhattan, New York,7,1439,832,607,7844,3348,4496,190,110,80,1043,1182,1722,910,469,441
1400000US36061000800,Census Tract 8,Manhattan, New York,7,634,237,397,8706,3868,4838,48,18,35,592,1396,2056,1106,588,518
1400000US36061001001,Census Tract 10.01,Manhattan, New York,7,26,26,0,1183,573,610,0,0,0,0,57,13,67,56,12
1400000US36061001002,Census Tract 10.02,Manhattan, New York,7,562,232,330,4419,1899,2520,206,85,135,1485,408,708,977,384,595
1400000US36061001200,Census Tract 12,Manhattan, New York,7,124,61,63,3008,1434,1574,14,7,14,0,120,283,205,83,123
1400000US36061001401,Census Tract 14.01,Manhattan, New York,7,110,35,75,2632,1254,1378,0,0,0,0,34,127,82,29,52
1400000US36061001402,Census Tract 14.02,Manhattan, New York,7,288,141,147,2249,1090,1159,120,59,22,1514,222,242,268,152,116
1400000US36061001800,Census Tract 18,Manhattan, New York,7,892,494,398,5677,2926,2751,159,88,119,159,606,913,568,287,278
1400000US36061002201,Census Tract 22.01,Manhattan, New York,7,657,300,357,4845,2245,2600,99,45,83,392,496,528,426,233,192
1400000US36061002000,Census Tract 20,Manhattan, New York,9,567,252,315,3158,1180,1978,153,68,116,600,392,572,521,251,269
1400000US36061002202,Census Tract 22.02,Manhattan, New York,9,330,54,276,1651,957,694,21,3,15,107,50,68,121,73,48
1400000US36061002400,Census Tract 24,Manhattan, New York,9,690,370,320,3589,1579,2010,266,143,94,1762,376,482,693,335,360
1400000US36061002601,Census Tract 26.01,Manhattan, New York,9,484,249,235,2736,1335,1401,125,64,54,791,192,217,339,179,160
1400000US36061002602,Census Tract 26.02,Manhattan, New York,9,617,393,224,3120,1427,1693,55,35,24,168,186,245,175,3,173
1400000US36061002800,Census Tract 28,Manhattan, New York,9,704,432,272,5368,2800,2568,143,88,72,574,244,588,521,213,306
1400000US36061003002,Census Tract 30.02,Manhattan, New York,9,180,53,127,2480,1317,1163,8,2,19,0,68,120,124,36,87
1400000US36061003200,Census Tract 32,Manhattan, New York,9,972,483,489,6844,3296,3548,17,8,17,0,76,319,376,194,177
1400000US36061003400,Census Tract 34,Manhattan, New York,9,942,318,624,5232,2400,2832,66,22,130,0,65,150,94,14,79
1400000US36061003602,Census Tract 36.02,Manhattan, New York,9,247,75,172,2237,1520,717,17,5,39,0,53,80,217,138,77
1400000US36061003800,Census Tract 38,Manhattan, New York,9,1459,444,1015,6619,3478,3141,7,2,18,0,101,148,364,191,173
1400000US36061004000,Census Tract 40,Manhattan, New York,9,2712,1092,1620,5686,3044,2642,0,0,0,0,140,48,125,103,21
1400000US36061004200,Census Tract 42,Manhattan, New York,9,1664,299,1365,2317,1238,1079,8,1,10,12,0,0,46,45,2
1400000US36061005502,Census Tract 55.02,Manhattan, New York,9,163,60,103,1634,891,743,22,8,24,127,20,0,54,40,14
1400000US36061006100,Census Tract 61,Manhattan, New York,9,1728,710,1018,3327,1787,1540,0,0,0,0,13,0,0,0,0
1400000US36061008300,Census Tract 83,Manhattan, New York,10,494,238,256,2867,1474,1393,82,40,68,212,125,169,367,161,208
1400000US36061008900,Census Tract 89,Manhattan, New York,10,573,281,292,4865,2778,2087,12,6,13,0,61,46,78,50,27
1400000US36061009100,Census Tract 91,Manhattan, New York,10,718,252,466,5196,2803,2393,42,15,57,125,42,2,31,8,22
1400000US36061009300,Census Tract 93,Manhattan, New York,10,401,123,278,7767,3636,4131,70,22,0,1957,36,186,396,182,219
1400000US36061009900,Census Tract 99,Manhattan, New York,10,411,337,74,1977,1099,878,7,6,0,188,16,7,115,51,63
1400000US36061011700,Census Tract 117,Manhattan, New York,10,244,110,134,1542,898,644,0,0,0,0,0,0,46,0,47
1400000US36061004400,Census Tract 44,Manhattan, New York,13,2785,1088,1697,12867,5559,7308,14,5,0,116,22,292,373,245,124
1400000US36061004800,Census Tract 48,Manhattan, New York,13,850,279,571,5381,2649,2732,16,5,0,151,101,60,75,64,11
1400000US36061005000,Census Tract 50,Manhattan, New York,13,459,33,426,4750,2216,2534,13,1,0,147,9,25,48,22,25
1400000US36061005200,Census Tract 52,Manhattan, New York,13,1196,342,854,2402,1285,1117,26,8,0,72,0,0,22,22,0
1400000US36061005400,Census Tract 54,Manhattan, New York,13,274,87,187,3506,1810,1696,4,1,0,74,45,39,84,31,54
1400000US36061005600,Census Tract 56,Manhattan, New York,13,198,49,149,2280,1064,1216,29,7,0,445,11,0,50,15,36
1400000US36061005800,Census Tract 58,Manhattan, New York,13,314,81,233,2662,1239,1423,0,0,0,0,40,0,48,0,48
1400000US36061006000,Census Tract 60,Manhattan, New York,13,148,78,70,3713,1733,1980,0,0,0,0,0,0,56,16,42
1400000US36061006400,Census Tract 64,Manhattan, New York,13,620,234,386,6607,2813,3794,0,0,0,0,17,19,159,76,83
1400000US36061006600,Census Tract 66,Manhattan, New York,13,2540,1270,1270,8997,4332,4665,216,108,66,1062,117,341,351,182,173
1400000US36061006800,Census Tract 68,Manhattan, New York,13,1100,500,600,4533,2173,2360,0,0,0,0,33,14,63,46,17
1400000US36061007200,Census Tract 72,Manhattan, New York,13,1659,414,1245,6369,3024,3345,5,1,0,25,42,43,64,57,3
1400000US36061007400,Census Tract 74,Manhattan, New York,13,900,164,736,3248,1664,1584,14,3,0,62,0,0,23,22,0
1400000US36061007600,Census Tract 76,Manhattan, New York,13,511,235,276,1471,872,599,0,0,0,0,58,47,29,21,9
1400000US36061008100,Census Tract 81,Manhattan, New York,13,465,234,231,6833,4060,2773,64,32,63,0,37,150,55,57,3
1400000US36061008700,Census Tract 87,Manhattan, New York,13,387,137,250,5478,2996,2482,11,4,0,241,63,82,131,69,62
1400000US36061009500,Census Tract 95,Manhattan, New York,13,1458,328,1130,1464,732,732,7,2,0,10,0,22,12,4,8
1400000US36061008000,Census Tract 80,Manhattan, New York,14,357,33,324,4275,1979,2296,8,1,0,107,0,0,56,4,55
1400000US36061008400,Census Tract 84,Manhattan, New York,14,372,241,131,1127,717,410,16,10,9,0,9,0,0,0,0
1400000US36061009200,Census Tract 92,Manhattan, New York,14,136,35,101,1574,824,750,0,0,0,0,13,0,68,20,48
1400000US36061009700,Census Tract 97,Manhattan, New York,14,314,119,195,3955,1964,1991,51,19,84,0,22,189,233,141,94
1400000US36061010100,Census Tract 101,Manhattan, New York,14,107,81,26,639,385,254,0,0,0,0,5,0,48,21,27
1400000US36061010300,Census Tract 103,Manhattan, New York,14,318,169,149,1465,799,666,21,11,0,207,12,2,0,0,0
1400000US36061010900,Census Tract 109,Manhattan, New York,14,7,0,7,90,54,36,0,0,0,0,0,0,1,1,0
1400000US36061011100,Census Tract 111,Manhattan, New York,14,341,82,259,2404,1306,1098,0,0,0,0,52,96,101,57,43
1400000US36061011300,Census Tract 113,Manhattan, New York,14,120,24,96,116,41,75,3,1,12,0,8,0,21,17,4
1400000US36061011500,Census Tract 115,Manhattan, New York,14,391,160,231,1567,935,632,61,25,33,259,103,39,89,59,30
1400000US36061007000,Census Tract 70,Manhattan, New York,17,1338,491,847,7094,3696,3398,24,9,42,0,129,54,35,18,14
1400000US36061007800,Census Tract 78,Manhattan, New York,17,685,130,555,6612,3076,3536,0,0,0,0,31,57,53,18,35
1400000US36061008200,Census Tract 82,Manhattan, New York,17,232,109,123,3052,1259,1793,0,0,0,0,15,38,82,83,0
1400000US36061008603,Census Tract 86.03,Manhattan, New York,17,365,203,162,3812,1684,2128,13,7,10,0,0,19,0,0,0
1400000US36061008800,Census Tract 88,Manhattan, New York,17,568,169,399,5933,2703,3230,0,0,0,0,0,39,101,46,55
1400000US36061009000,Census Tract 90,Manhattan, New York,17,1078,537,541,5326,2456,2870,15,8,0,149,0,75,117,56,63
1400000US36061009800,Census Tract 98,Manhattan, New York,17,512,201,311,5604,2463,3141,9,4,14,0,7,47,56,34,25
1400000US36061010601,Census Tract 106.01,Manhattan, New York,17,149,57,92,6403,2774,3629,0,0,0,0,0,0,96,39,58
1400000US36061010800,Census Tract 108,Manhattan, New York,17,617,290,327,6965,3030,3935,0,0,0,0,0,0,14,15,0
1400000US36061011203,Census Tract 112.03,Manhattan, New York,17,246,13,233,811,384,427,0,0,0,0,8,0,0,0,0
1400000US36061009400,Census Tract 94,Manhattan, New York,18,0,0,0,27,18,9,0,0,0,0,10,0,0,0,0
1400000US36061009600,Census Tract 96,Manhattan, New York,18,4,4,0,149,94,55,0,0,0,0,0,1,0,0,0
1400000US36061010000,Census Tract 100,Manhattan, New York,18,29,10,19,1592,785,807,0,0,0,0,28,0,11,11,0
1400000US36061010200,Census Tract 102,Manhattan, New York,18,17,0,17,158,81,77,10,0,0,93,0,0,2,2,0
1400000US36061010400,Census Tract 104,Manhattan, New York,18,77,42,35,949,448,501,0,0,0,0,2,0,13,0,13
1400000US36061011201,Census Tract 112.01,Manhattan, New York,18,28,0,28,751,402,349,0,0,0,0,0,10,8,0,8
1400000US36061011202,Census Tract 112.02,Manhattan, New York,18,0,0,0,274,122,152,0,0,0,0,0,0,10,0,10
1400000US36061011900,Census Tract 119,Manhattan, New York,18,23,23,0,1083,698,385,0,0,0,0,114,7,84,61,24
1400000US36061012100,Census Tract 121,Manhattan, New York,18,698,448,250,7706,4096,3610,46,30,26,0,180,245,277,172,105
1400000US36061012500,Census Tract 125,Manhattan, New York,18,152,60,92,2071,1229,842,24,9,37,0,12,15,27,14,13
1400000US36061012700,Census Tract 127,Manhattan, New York,18,841,354,487,5708,3021,2687,87,36,120,0,169,148,280,85,196
1400000US36061013100,Census Tract 131,Manhattan, New York,18,192,114,78,2287,1159,1128,0,0,0,0,74,58,80,25,56
1400000US36061013300,Census Tract 133,Manhattan, New York,18,796,317,479,5052,2719,2333,123,49,171,106,106,196,308,133,175
1400000US36061013500,Census Tract 135,Manhattan, New York,18,658,213,445,4119,2031,2088,85,27,65,498,122,311,325,256,71
1400000US36061013700,Census Tract 137,Manhattan, New York,18,101,76,25,6097,2923,3174,0,0,0,0,15,0,61,0,57
1400000US36061013900,Census Tract 139,Manhattan, New York,18,688,229,459,7374,3441,3933,0,0,0,0,89,169,66,14,51
1400000US36047009400,Census Tract 94,Brooklyn, New York,19,548,269,279,3331,1614,1717,110,54,50,739,436,491,536,297,239
1400000US36061010602,Census Tract 106.02,Manhattan, New York,19,464,160,304,3725,1682,2043,0,0,0,0,50,16,108,0,106
1400000US36061011000,Census Tract 110,Manhattan, New York,19,414,129,285,6024,2659,3365,0,0,0,0,16,13,120,72,50
1400000US36061011401,Census Tract 114.01,Manhattan, New York,19,64,38,26,1093,539,554,0,0,0,0,12,0,0,0,0
1400000US36061011402,Census Tract 114.02,Manhattan, New York,19,57,21,36,2141,954,1187,0,0,0,0,0,0,24,23,0
1400000US36061011600,Census Tract 116,Manhattan, New York,19,466,214,252,2954,1375,1579,19,9,22,0,0,14,106,23,81
1400000US36061011800,Census Tract 118,Manhattan, New York,19,539,287,252,7619,3607,4012,19,10,0,571,7,16,84,87,0
1400000US36061012000,Census Tract 120,Manhattan, New York,19,101,78,23,3267,1250,2017,7,5,0,993,0,40,56,0,54
1400000US36061012200,Census Tract 122,Manhattan, New York,19,56,40,16,2450,1045,1405,0,0,0,0,0,18,25,11,13
1400000US36061012400,Census Tract 124,Manhattan, New York,19,622,213,409,7847,3350,4497,9,3,17,0,0,99,110,3,103
1400000US36061012600,Census Tract 126,Manhattan, New York,19,630,279,351,9838,3723,6115,7,3,0,197,26,43,79,48,31
1400000US36061012800,Census Tract 128,Manhattan, New York,19,215,106,109,4942,2200,2742,37,18,19,860,7,5,114,29,85
1400000US36061013000,Census Tract 130,Manhattan, New York,19,118,103,15,3251,1432,1819,32,28,5,0,0,67,23,9,15
1400000US36061013200,Census Tract 132,Manhattan, New York,19,900,387,513,7442,2915,4527,12,5,0,171,15,91,52,0,54
1400000US36061013400,Census Tract 134,Manhattan, New York,19,631,209,422,9043,3911,5132,3,1,0,63,16,15,226,70,154
1400000US36061013600,Census Tract 136,Manhattan, New York,19,853,237,616,12194,4939,7255,11,3,0,219,64,36,122,54,65
1400000US36061013800,Census Tract 138,Manhattan, New York,19,1192,319,873,10666,4613,6053,4,1,8,0,83,157,181,97,85
1400000US36061014000,Census Tract 140,Manhattan, New York,19,317,34,283,6292,2796,3496,18,2,0,403,0,42,63,45,14
1400000US36061014200,Census Tract 142,Manhattan, New York,19,209,165,44,3389,1451,1938,7,5,0,539,0,17,20,0,21
1400000US36061014401,Census Tract 144.01,Manhattan, New York,19,178,96,82,3868,1739,2129,13,7,0,615,0,0,15,0,15
1400000US36061014402,Census Tract 144.02,Manhattan, New York,19,524,162,362,5384,2429,2955,0,0,0,0,0,50,48,17,27
1400000US36061014601,Census Tract 146.01,Manhattan, New York,19,226,108,118,3077,1474,1603,6,3,2,105,46,14,37,32,6
1400000US36061014602,Census Tract 146.02,Manhattan, New York,19,767,266,501,6718,3044,3674,0,0,0,0,6,37,94,73,22
1400000US36061014801,Census Tract 148.01,Manhattan, New York,19,28,0,28,2144,988,1156,0,0,0,0,16,0,9,9,0
1400000US36061014802,Census Tract 148.02,Manhattan, New York,19,251,69,182,5285,2536,2749,0,0,0,0,28,47,63,63,0
1400000US36061015001,Census Tract 150.01,Manhattan, New York,19,98,64,34,1807,879,928,0,0,0,0,0,0,7,7,0
1400000US36061015002,Census Tract 150.02,Manhattan, New York,19,299,57,242,4376,2004,2372,20,4,8,324,0,0,18,16,0
1400000US36061015400,Census Tract 154,Manhattan, New York,19,858,374,484,10561,4836,5725,101,44,49,1373,387,395,275,92,177
1400000US36061015601,Census Tract 156.01,Manhattan, New York,19,588,200,388,4365,1724,2641,13,4,0,148,3,5,74,21,53
1400000US36061015801,Census Tract 158.01,Manhattan, New York,19,341,141,200,3814,1560,2254,21,9,0,400,0,11,46,14,32
1400000US36061016001,Census Tract 160.01,Manhattan, New York,19,149,84,65,2617,1153,1464,23,13,18,0,0,0,50,2,48
1400000US36061014500,Census Tract 145,Manhattan, New York,20,1041,360,681,4237,2383,1854,10,4,0,64,0,0,8,0,9
1400000US36061014700,Census Tract 147,Manhattan, New York,20,79,7,72,1737,847,890,0,0,0,0,116,0,7,0,7
1400000US36061014900,Census Tract 149,Manhattan, New York,20,408,220,188,4217,1781,2436,7,4,6,0,0,0,72,37,34
1400000US36061015100,Census Tract 151,Manhattan, New York,20,671,419,252,5639,2123,3516,72,45,30,491,59,299,643,225,418
1400000US36061015300,Census Tract 153,Manhattan, New York,20,250,96,154,7674,3591,4083,1,0,2,0,72,65,61,22,41
1400000US36061015500,Census Tract 155,Manhattan, New York,20,190,75,115,8193,3439,4754,0,0,0,0,0,43,90,28,62
1400000US36061015700,Census Tract 157,Manhattan, New York,20,607,373,234,8416,4384,4032,0,0,0,0,61,97,109,101,12
1400000US36061015900,Census Tract 159,Manhattan, New York,20,499,391,108,7293,3406,3887,2,2,1,0,0,16,73,61,12
1400000US36061016100,Census Tract 161,Manhattan, New York,20,288,162,126,5361,2462,2899,0,0,0,0,20,35,16,0,14
1400000US36061016300,Census Tract 163,Manhattan, New York,20,284,196,88,5582,2553,3029,17,12,8,0,79,27,17,0,18
1400000US36061016500,Census Tract 165,Manhattan, New York,20,275,123,152,5823,3080,2743,0,0,0,0,0,16,29,28,0
1400000US36061016700,Census Tract 167,Manhattan, New York,20,453,196,257,4957,2357,2600,22,10,0,426,33,26,40,24,18
1400000US36061016900,Census Tract 169,Manhattan, New York,20,381,238,143,6702,3004,3698,31,19,19,0,75,15,141,45,96
1400000US36061017100,Census Tract 171,Manhattan, New York,20,369,141,228,7871,3736,4135,0,0,0,0,45,116,205,78,128
1400000US36061014300,Census Tract 143,Manhattan, New York,22,0,0,0,14,13,1,0,0,0,0,0,0,1,0,1
1400000US36061015602,Census Tract 156.02,Manhattan, New York,23,257,190,67,1695,842,853,156,115,42,936,52,158,219,174,45
1400000US36061015802,Census Tract 158.02,Manhattan, New York,23,449,143,306,2536,1216,1320,9,3,0,74,21,30,53,19,32
1400000US36061016002,Census Tract 160.02,Manhattan, New York,23,1035,514,521,2145,1103,1042,10,5,10,0,17,43,127,50,76
1400000US36061016200,Census Tract 162,Manhattan, New York,23,1051,607,444,6181,2444,3737,238,137,71,1947,281,460,983,494,490
1400000US36061016400,Census Tract 164,Manhattan, New York,23,747,345,402,4254,1873,2381,317,146,241,1166,191,464,719,375,343
1400000US36061016600,Census Tract 166,Manhattan, New York,23,934,378,556,5252,2586,2666,123,50,82,635,465,357,856,398,459
1400000US36061016800,Census Tract 168,Manhattan, New York,23,423,307,116,3369,1231,2138,132,96,41,697,231,321,647,174,475
1400000US36061017000,Census Tract 170,Manhattan, New York,23,881,757,124,5992,2555,3437,270,232,36,2463,314,436,689,360,330
1400000US36061017200,Census Tract 172,Manhattan, New York,23,832,529,303,3657,2012,1645,235,149,101,713,300,456,490,264,225
1400000US36061017401,Census Tract 174.01,Manhattan, New York,23,526,276,250,3189,1362,1827,291,153,204,842,94,238,574,191,385
1400000US36061017402,Census Tract 174.02,Manhattan, New York,23,393,161,232,1672,854,818,49,20,52,94,48,104,336,209,127
1400000US36061017800,Census Tract 178,Manhattan, New York,23,414,202,212,3293,1411,1882,43,21,3,622,262,245,514,159,354
1400000US36061018000,Census Tract 180,Manhattan, New York,23,1108,609,499,4265,1618,2647,565,311,328,1412,257,490,729,223,508
1400000US36061018200,Census Tract 182,Manhattan, New York,23,672,255,417,4212,1888,2324,260,99,289,838,395,493,897,415,481
1400000US36061018400,Census Tract 184,Manhattan, New York,23,1009,617,392,5343,2340,3003,438,268,191,1881,573,508,705,276,432
1400000US36061017300,Census Tract 173,Manhattan, New York,24,581,179,402,7122,3108,4014,56,17,65,477,137,153,157,47,112
1400000US36061017500,Census Tract 175,Manhattan, New York,24,511,191,320,8450,3788,4662,18,7,30,0,170,205,220,38,186
1400000US36061017700,Census Tract 177,Manhattan, New York,24,594,218,376,6644,2751,3893,143,53,91,1588,162,280,419,223,195
1400000US36061017900,Census Tract 179,Manhattan, New York,24,419,205,214,6990,3444,3546,42,21,33,329,103,113,140,55,85
1400000US36061018100,Census Tract 181,Manhattan, New York,24,779,219,560,7323,2999,4324,0,0,0,0,42,35,286,93,190
1400000US36061018300,Census Tract 183,Manhattan, New York,24,701,259,442,6989,3172,3817,9,3,0,140,44,130,189,63,126
1400000US36061018500,Census Tract 185,Manhattan, New York,24,114,24,90,3607,1770,1837,19,4,0,761,0,31,79,34,44
1400000US36061018700,Census Tract 187,Manhattan, New York,24,579,254,325,7011,3696,3315,63,28,81,0,74,103,266,225,36
1400000US36061018900,Census Tract 189,Manhattan, New York,24,1014,360,654,8414,3175,5239,115,41,42,1186,311,608,1144,403,739
1400000US36061019100,Census Tract 191,Manhattan, New York,24,631,239,392,7296,3052,4244,66,25,0,1226,24,263,175,12,161
1400000US36061019300,Census Tract 193,Manhattan, New York,24,1551,813,738,6047,2627,3420,437,229,266,1179,221,479,417,179,239
1400000US36061019500,Census Tract 195,Manhattan, New York,24,1003,517,486,5821,2889,2932,0,0,0,0,130,147,256,220,32
1400000US36061018800,Census Tract 188,Manhattan, New York,25,837,417,420,4076,2104,1972,377,188,202,1708,438,550,832,553,278
1400000US36061019200,Census Tract 192,Manhattan, New York,25,597,301,296,2146,788,1358,164,83,105,414,205,219,496,195,300
1400000US36061019400,Census Tract 194,Manhattan, New York,25,1211,688,523,3468,1518,1950,206,117,109,416,366,365,739,263,476
1400000US36061019600,Census Tract 196,Manhattan, New York,25,455,180,275,2474,962,1512,158,62,101,829,267,423,408,201,207
1400000US36061019800,Census Tract 198,Manhattan, New York,25,81,8,73,1521,621,900,0,0,0,0,16,86,113,33,79
1400000US36061020600,Census Tract 206,Manhattan, New York,25,266,91,175,2008,1127,881,104,36,90,655,88,92,474,334,140
1400000US36061024000,Census Tract 240,Manhattan, New York,25,87,79,8,1277,982,295,48,44,4,1277,150,45,319,217,102
1400000US36061024200,Census Tract 242,Manhattan, New York,25,345,107,238,1989,944,1045,127,39,122,603,107,56,495,347,148
1400000US36061019701,Census Tract 197.01,Manhattan, New York,26,46,8,38,359,153,206,2,0,10,0,0,12,3,3,0
1400000US36061019900,Census Tract 199,Manhattan, New York,26,2995,1001,1994,5996,2527,3469,3,1,6,0,106,219,114,33,76
1400000US36061020101,Census Tract 201.01,Manhattan, New York,26,1549,735,814,641,288,353,0,0,0,0,0,32,16,0,16
1400000US36061020300,Census Tract 203,Manhattan, New York,26,2704,1069,1635,941,422,519,3,1,0,2,0,23,21,21,0
1400000US36061020500,Census Tract 205,Manhattan, New York,26,2218,455,1763,2231,1122,1109,40,8,0,51,8,0,33,25,8
1400000US36061020701,Census Tract 207.01,Manhattan, New York,26,567,240,327,2225,1138,1087,0,0,0,0,15,13,49,33,16
1400000US36061020901,Census Tract 209.01,Manhattan, New York,26,433,186,247,2654,1278,1376,165,71,109,892,127,268,403,170,234
1400000US36061021100,Census Tract 211,Manhattan, New York,26,871,490,381,7232,2669,4563,102,57,69,268,160,287,391,104,287
1400000US36061021303,Census Tract 213.03,Manhattan, New York,26,439,224,215,3894,2095,1799,136,69,75,1051,362,248,378,251,126
1400000US36061021703,Census Tract 217.03,Manhattan, New York,26,0,0,0,0,0,0,0,0,0,0,0,0,0,0,0
1400000US36061022700,Census Tract 227,Manhattan, New York,26,735,253,482,3812,1650,2162,112,38,148,271,69,80,377,101,277
1400000US36061018600,Census Tract 186,Manhattan, New York,28,804,362,442,3747,1506,2241,245,110,161,959,215,285,892,321,569
1400000US36061019000,Census Tract 190,Manhattan, New York,28,327,144,183,1994,826,1168,32,14,12,251,16,148,116,53,62
1400000US36061019702,Census Tract 197.02,Manhattan, New York,28,136,65,71,1499,700,799,28,13,11,381,0,12,49,23,27
1400000US36061020000,Census Tract 200,Manhattan, New York,28,210,141,69,2366,1229,1137,37,25,17,69,18,42,92,49,44
1400000US36061020102,Census Tract 201.02,Manhattan, New York,28,551,196,355,2779,1179,1600,110,39,76,534,59,88,384,256,128
1400000US36061020800,Census Tract 208,Manhattan, New York,28,672,381,291,2955,1433,1522,88,50,14,712,54,52,363,191,174
1400000US36061021500,Census Tract 215,Manhattan, New York,28,439,296,143,2090,674,1416,86,58,42,0,77,144,355,99,256
1400000US36061021600,Census Tract 216,Manhattan, New York,28,762,446,316,5385,2480,2905,205,120,108,889,228,203,571,335,232
1400000US36061021800,Census Tract 218,Manhattan, New York,28,1074,548,526,4074,1867,2207,288,147,183,758,189,117,448,192,256
1400000US36061022000,Census Tract 220,Manhattan, New York,28,581,164,417,3915,1709,2206,76,21,158,133,116,68,235,79,159
1400000US36061022200,Census Tract 222,Manhattan, New York,28,151,72,79,1787,747,1040,50,24,37,363,18,25,157,59,99
1400000US36061022400,Census Tract 224,Manhattan, New York,28,802,464,338,3797,1250,2547,278,161,138,987,166,117,976,319,657
1400000US36061025700,Census Tract 257,Manhattan, New York,28,479,227,252,2695,1007,1688,60,28,67,0,39,100,213,98,115
1400000US36061021900,Census Tract 219,Manhattan, New York,30,836,322,514,3439,1620,1819,166,64,77,791,363,526,543,235,307
1400000US36061022301,Census Tract 223.01,Manhattan, New York,30,1293,551,742,5002,2563,2439,366,156,170,1616,812,773,745,310,434
1400000US36061022302,Census Tract 223.02,Manhattan, New York,30,490,221,269,2377,943,1434,132,59,111,361,93,219,383,160,224
1400000US36061022500,Census Tract 225,Manhattan, New York,30,913,280,633,7423,3200,4223,120,37,70,1047,518,718,854,330,524
1400000US36061022900,Census Tract 229,Manhattan, New York,30,1434,890,544,5692,2761,2931,348,216,132,1383,856,621,416,207,211
1400000US36061023100,Census Tract 231,Manhattan, New York,30,681,401,280,4395,2214,2181,108,64,61,312,476,345,272,155,118
1400000US36061023300,Census Tract 233,Manhattan, New York,30,871,496,375,4211,2110,2101,153,87,116,0,177,166,383,169,214
1400000US36061023501,Census Tract 235.01,Manhattan, New York,30,908,599,309,4360,2102,2258,117,77,37,650,174,375,737,458,280
1400000US36061023700,Census Tract 237,Manhattan, New York,30,863,459,404,4513,2042,2471,174,93,73,1015,361,393,609,241,371
1400000US36061021000,Census Tract 210,Manhattan, New York,32,1144,329,815,4815,1653,3162,410,118,267,1786,159,221,453,88,364
1400000US36061021200,Census Tract 212,Manhattan, New York,32,212,22,190,3182,1339,1843,41,4,0,687,25,66,328,96,232
1400000US36061021400,Census Tract 214,Manhattan, New York,32,151,113,38,2629,1151,1478,14,11,5,0,14,95,210,110,101
1400000US36061022102,Census Tract 221.02,Manhattan, New York,32,270,100,170,1610,678,932,8,3,12,10,0,11,200,76,123
1400000US36061022600,Census Tract 226,Manhattan, New York,32,439,250,189,3041,1491,1550,65,37,49,0,83,84,271,163,107
1400000US36061022800,Census Tract 228,Manhattan, New York,32,356,166,190,3946,2048,1898,51,24,29,541,236,108,375,209,163
1400000US36061023000,Census Tract 230,Manhattan, New York,32,1293,666,627,5983,2656,3327,371,191,120,2327,600,433,951,372,582
1400000US36061023200,Census Tract 232,Manhattan, New York,32,1113,441,672,4899,2103,2796,372,147,276,1391,219,403,784,366,417
1400000US36061023400,Census Tract 234,Manhattan, New York,32,674,403,271,3380,1640,1740,121,73,64,324,89,137,321,103,219
1400000US36061023502,Census Tract 235.02,Manhattan, New York,32,126,73,53,1310,546,764,22,13,16,0,90,82,212,128,84
1400000US36061023600,Census Tract 236,Manhattan, New York,32,540,266,274,4610,1678,2932,110,54,113,0,168,135,599,315,284
1400000US36061024302,Census Tract 243.02,Manhattan, New York,32,1268,657,611,3837,1338,2499,568,294,346,1232,272,550,775,217,557
1400000US36061025900,Census Tract 259,Manhattan, New York,32,382,138,244,2141,983,1158,120,43,9,1008,162,207,165,83,82
1400000US36061023900,Census Tract 239,Manhattan, New York,33,245,148,97,1694,772,922,26,16,5,315,139,147,310,172,138
1400000US36061024100,Census Tract 241,Manhattan, New York,33,1155,648,507,6162,2899,3263,447,251,293,887,658,630,1017,435,584
1400000US36061024301,Census Tract 243.01,Manhattan, New York,33,621,346,275,2891,1690,1201,220,122,146,379,433,246,457,269,189
1400000US36061024500,Census Tract 245,Manhattan, New York,33,2062,993,1069,10003,4760,5243,608,293,273,3321,1071,1326,2021,1109,907
1400000US36061024700,Census Tract 247,Manhattan, New York,33,1242,492,750,5513,2727,2786,438,174,422,1191,684,777,656,183,471
1400000US36061024900,Census Tract 249,Manhattan, New York,33,122,66,56,600,268,332,26,14,1,268,63,81,70,51,19
1400000US36061025100,Census Tract 251,Manhattan, New York,33,453,161,292,2009,972,1037,121,43,116,392,193,342,265,149,117
1400000US36061025300,Census Tract 253,Manhattan, New York,33,1562,788,774,8196,4248,3948,461,232,217,2541,1198,1263,1410,833,576
1400000US36061025500,Census Tract 255,Manhattan, New York,33,1066,450,616,4078,2188,1890,25,10,34,0,151,183,228,94,134
1400000US36061027500,Census Tract 275,Manhattan, New York,33,73,38,35,2399,1044,1355,14,7,8,343,0,19,74,32,42
1400000US36061031100,Census Tract 311,Manhattan, New York,33,0,0,0,0,0,0,0,0,0,0,0,0,0,0,0
1400000US36061026100,Census Tract 261,Manhattan, New York,34,1496,794,702,8597,4447,4150,627,333,347,2863,1356,1204,1522,947,573
1400000US36061026300,Census Tract 263,Manhattan, New York,34,1058,360,698,6594,3188,3406,174,59,134,983,705,858,936,328,606
1400000US36061026500,Census Tract 265,Manhattan, New York,34,822,506,316,5615,2828,2787,167,103,86,517,215,513,466,280,190
1400000US36061026700,Census Tract 267,Manhattan, New York,34,1273,1113,160,786,362,424,9,8,1,0,51,33,113,15,98
1400000US36061026900,Census Tract 269,Manhattan, New York,34,1503,1006,497,5721,2639,3082,83,55,39,46,760,546,1036,433,601
1400000US36061027100,Census Tract 271,Manhattan, New York,34,1221,767,454,6107,2757,3350,105,66,40,495,579,807,818,419,399
1400000US36061027300,Census Tract 273,Manhattan, New York,34,423,195,228,5064,2144,2920,0,0,0,0,15,85,86,34,53
1400000US36061027700,Census Tract 277,Manhattan, New York,34,857,549,308,5103,2058,3045,88,57,49,0,395,859,852,327,524
1400000US36061027900,Census Tract 279,Manhattan, New York,34,1512,841,671,7006,2536,4470,287,160,167,827,289,849,1051,403,648
1400000US36061028100,Census Tract 281,Manhattan, New York,34,173,111,62,2161,1032,1129,0,0,0,0,18,19,19,11,9
1400000US36061028300,Census Tract 283,Manhattan, New York,34,965,354,611,5342,2212,3130,203,74,207,727,314,263,609,323,288
1400000US36061028500,Census Tract 285,Manhattan, New York,34,1029,563,466,5360,2418,2942,209,114,108,911,433,677,761,324,441
1400000US36061029100,Census Tract 291,Manhattan, New York,34,1227,604,623,7845,3231,4614,198,97,167,439,643,1329,1185,691,494
1400000US36061029300,Census Tract 293,Manhattan, New York,34,914,653,261,6089,3112,2977,346,247,93,2612,803,944,919,392,527
1400000US36061029500,Census Tract 295,Manhattan, New York,34,737,483,254,5905,3037,2868,403,264,154,2557,501,175,413,185,227
1400000US36061029700,Census Tract 297,Manhattan, New York,34,0,0,0,34,17,17,0,0,0,0,0,0,0,0,0
1400000US36061029900,Census Tract 299,Manhattan, New York,34,543,188,355,2668,1064,1604,108,37,155,195,226,404,336,116,220
1400000US36061030300,Census Tract 303,Manhattan, New York,34,246,127,119,2674,1301,1373,83,43,63,358,150,129,214,101,113
1400000US36061030700,Census Tract 307,Manhattan, New York,34,271,89,182,2681,1372,1309,94,31,127,472,56,30,24,4,20
1400000US36005001900,Census Tract 19,Bronx, New York,40,309,129,180,1056,558,498,100,42,60,335,37,109,193,137,56
1400000US36005002300,Census Tract 23,Bronx, New York,40,554,207,347,3071,1136,1935,182,68,213,488,281,393,768,258,511
1400000US36005002500,Census Tract 25,Bronx, New York,40,474,248,226,2808,1333,1475,231,121,113,1328,388,341,674,295,379
1400000US36005002701,Census Tract 27.01,Bronx, New York,40,438,264,174,1747,761,986,66,40,33,161,224,156,477,199,278
1400000US36005002702,Census Tract 27.02,Bronx, New York,40,692,349,343,2374,948,1426,318,161,181,928,225,394,482,251,230
1400000US36005003100,Census Tract 31,Bronx, New York,40,59,28,31,762,335,427,16,8,4,295,43,36,155,81,74
1400000US36005003300,Census Tract 33,Bronx, New York,40,561,265,296,1960,777,1183,106,50,81,218,143,295,378,146,232
1400000US36005003500,Census Tract 35,Bronx, New York,40,431,288,143,2260,1025,1235,179,120,67,696,204,222,484,165,317
1400000US36005003700,Census Tract 37,Bronx, New York,40,15,7,8,103,61,42,0,0,0,0,17,0,24,0,24
1400000US36005003900,Census Tract 39,Bronx, New York,40,798,381,417,4383,2484,1899,266,127,206,820,815,399,824,417,408
1400000US36005004100,Census Tract 41,Bronx, New York,40,997,462,535,3272,1402,1870,499,231,280,1571,435,415,641,142,499
1400000US36005004300,Census Tract 43,Bronx, New York,40,560,267,293,2913,1434,1479,97,46,62,408,404,180,612,215,398
1400000US36005005100,Census Tract 51,Bronx, New York,40,496,243,253,3195,1256,1939,197,96,123,997,273,504,697,329,368
1400000US36005006300,Census Tract 63,Bronx, New York,40,554,333,221,3393,1579,1814,115,69,62,339,283,256,746,313,434
1400000US36005006500,Census Tract 65,Bronx, New York,40,792,416,376,3023,1407,1616,258,136,148,756,433,246,656,208,449
1400000US36005006700,Census Tract 67,Bronx, New York,40,1053,484,569,4197,1753,2444,429,197,256,1557,466,694,848,442,408
1400000US36005007100,Census Tract 71,Bronx, New York,40,307,86,221,970,410,560,22,6,31,44,92,157,102,36,66
1400000US36005007300,Census Tract 73,Bronx, New York,40,301,90,211,2058,887,1171,110,33,106,634,219,240,418,118,299
1400000US36005007500,Census Tract 75,Bronx, New York,40,551,142,409,2561,982,1579,242,62,170,1145,221,268,553,223,330
1400000US36005007700,Census Tract 77,Bronx, New York,40,256,142,114,1077,445,632,82,45,23,501,63,91,305,84,221
1400000US36005007900,Census Tract 79,Bronx, New York,40,684,275,409,3538,1327,2211,136,55,47,899,305,624,984,407,577
1400000US36005008300,Census Tract 83,Bronx, New York,41,693,428,265,3399,1514,1885,284,175,129,962,329,439,687,306,379
1400000US36005008500,Census Tract 85,Bronx, New York,41,713,368,345,3098,1379,1719,293,151,160,1097,345,444,505,221,285
1400000US36005008700,Census Tract 87,Bronx, New York,41,972,533,439,3383,1381,2002,384,211,194,1140,423,424,754,347,408
1400000US36005008900,Census Tract 89,Bronx, New York,41,435,100,335,1734,860,874,121,28,80,503,229,188,536,287,248
1400000US36005009300,Census Tract 93,Bronx, New York,41,994,603,391,3610,1815,1795,508,308,226,1469,211,266,1090,664,427
1400000US36005011502,Census Tract 115.02,Bronx, New York,41,513,277,236,2402,1055,1347,193,104,89,906,262,273,430,178,251
1400000US36005011700,Census Tract 117,Bronx, New York,41,126,32,94,793,259,534,34,9,44,160,0,30,269,72,197
1400000US36005011900,Census Tract 119,Bronx, New York,41,612,330,282,3167,1381,1786,256,138,124,1248,246,338,808,441,366
1400000US36005012102,Census Tract 121.02,Bronx, New York,41,84,70,14,707,251,456,66,55,10,707,109,109,99,13,86
1400000US36005012300,Census Tract 123,Bronx, New York,41,279,143,136,1840,773,1067,40,20,30,109,256,153,412,135,277
1400000US36005012500,Census Tract 125,Bronx, New York,41,455,254,201,1668,597,1071,112,62,82,75,78,20,255,40,215
1400000US36005012701,Census Tract 127.01,Bronx, New York,41,207,148,59,1317,620,697,51,36,19,67,214,162,171,70,101
1400000US36005015100,Census Tract 151,Bronx, New York,41,657,384,273,3213,1337,1876,202,118,52,1520,235,356,530,209,321
1400000US36005015900,Census Tract 159,Bronx, New York,41,185,126,59,1347,485,862,106,72,39,502,205,221,422,85,336
1400000US36005006000,Census Tract 60,Bronx, New York,42,202,76,126,754,379,375,85,32,86,198,56,103,70,12,58
1400000US36005006900,Census Tract 69,Bronx, New York,42,639,269,370,3584,1373,2211,257,108,75,1957,224,467,720,242,480
1400000US36005012101,Census Tract 121.01,Bronx, New York,42,501,222,279,1468,643,825,239,106,109,800,140,203,242,77,165
1400000US36005012901,Census Tract 129.01,Bronx, New York,42,256,144,112,1614,599,1015,96,54,69,102,126,135,365,133,231
1400000US36005013100,Census Tract 131,Bronx, New York,42,732,384,348,2783,1137,1646,270,142,125,1055,334,275,540,238,301
1400000US36005013300,Census Tract 133,Bronx, New York,42,855,456,399,4099,1857,2242,216,115,107,967,514,491,656,227,426
1400000US36005013500,Census Tract 135,Bronx, New York,42,371,185,186,2144,841,1303,162,81,125,437,164,242,403,137,265
1400000US36005014100,Census Tract 141,Bronx, New York,42,322,171,151,1536,531,1005,112,60,68,356,142,158,389,143,245
1400000US36005014500,Census Tract 145,Bronx, New York,42,896,407,489,2878,1163,1715,423,192,198,1520,143,256,708,252,456
1400000US36005014701,Census Tract 147.01,Bronx, New York,42,560,220,340,3268,968,2300,194,76,189,693,390,490,696,164,531
1400000US36005014702,Census Tract 147.02,Bronx, New York,42,909,451,458,2709,1047,1662,592,294,369,1355,342,563,650,226,424
1400000US36005014900,Census Tract 149,Bronx, New York,42,369,202,167,2456,987,1469,186,102,98,1000,171,234,420,149,270
1400000US36005015300,Census Tract 153,Bronx, New York,42,374,219,155,1991,884,1107,208,122,100,848,119,224,548,206,341
1400000US36005015500,Census Tract 155,Bronx, New York,42,428,221,207,1895,905,990,144,74,77,569,315,312,296,77,218
1400000US36005015700,Census Tract 157,Bronx, New York,42,415,173,242,1480,692,788,221,92,147,709,62,122,382,144,238
1400000US36005016100,Census Tract 161,Bronx, New York,42,506,278,228,2570,1037,1533,102,56,62,303,487,342,455,164,291
1400000US36005016300,Census Tract 163,Bronx, New York,42,69,17,52,89,43,46,34,8,0,58,0,5,54,30,24
1400000US36005016900,Census Tract 169,Bronx, New York,42,291,153,138,1044,405,639,147,77,90,356,59,153,183,97,86
1400000US36005018500,Census Tract 185,Bronx, New York,42,779,391,388,3703,1474,2229,252,126,157,896,298,285,889,394,495
1400000US36005035900,Census Tract 359,Bronx, New York,42,330,226,104,912,321,591,35,24,0,307,71,21,123,13,110
1400000US36005000200,Census Tract 2,Bronx, New York,43,656,215,441,2576,1281,1295,158,52,84,683,113,110,332,170,163
1400000US36005000400,Census Tract 4,Bronx, New York,43,465,322,143,3272,1565,1707,83,57,26,573,55,55,432,214,218
1400000US36005001600,Census Tract 16,Bronx, New York,43,424,196,228,3521,1527,1994,75,35,64,310,208,167,637,182,459
1400000US36005002000,Census Tract 20,Bronx, New York,43,879,421,458,5045,1773,3272,358,171,211,1806,275,507,1211,387,825
1400000US36005002400,Census Tract 24,Bronx, New York,43,0,0,0,0,0,0,0,0,0,0,0,0,0,0,0
1400000US36005002800,Census Tract 28,Bronx, New York,43,665,406,259,4239,1598,2641,164,100,71,852,35,114,585,297,288
1400000US36005003800,Census Tract 38,Bronx, New York,43,145,43,102,916,406,510,26,8,0,234,41,60,88,42,46
1400000US36005004001,Census Tract 40.01,Bronx, New York,43,207,106,101,1040,418,622,106,54,101,0,57,63,174,66,108
1400000US36005004200,Census Tract 42,Bronx, New York,43,817,495,322,4305,1569,2736,357,216,152,1657,190,421,659,187,473
1400000US36005004400,Census Tract 44,Bronx, New York,43,646,320,326,2680,1007,1673,300,148,132,1396,157,336,450,156,293
1400000US36005004600,Census Tract 46,Bronx, New York,43,201,55,146,1344,653,691,2,1,5,0,134,133,401,184,217
1400000US36005004800,Census Tract 48,Bronx, New York,43,319,82,237,2357,1161,1196,158,41,90,1263,266,332,455,228,228
1400000US36005005001,Census Tract 50.01,Bronx, New York,43,649,169,480,2622,1077,1545,351,91,273,1392,225,121,621,214,408
1400000US36005005002,Census Tract 50.02,Bronx, New York,43,1033,527,506,2794,1443,1351,696,355,372,1702,356,380,743,367,378
1400000US36005005200,Census Tract 52,Bronx, New York,43,122,65,57,1158,493,665,0,0,0,0,145,138,265,118,147
1400000US36005005400,Census Tract 54,Bronx, New York,43,853,388,465,3722,2092,1630,235,107,175,711,632,341,785,341,445
1400000US36005005600,Census Tract 56,Bronx, New York,43,177,140,37,1629,674,955,16,13,0,704,165,179,336,109,226
1400000US36005006200,Census Tract 62,Bronx, New York,43,964,409,555,3918,1718,2200,139,59,155,176,369,213,897,399,499
1400000US36005006400,Census Tract 64,Bronx, New York,43,597,319,278,2488,1130,1358,190,101,89,789,168,147,296,112,183
1400000US36005006800,Census Tract 68,Bronx, New York,43,188,115,73,1694,922,772,112,69,41,1115,96,67,302,188,113
1400000US36005007000,Census Tract 70,Bronx, New York,43,384,215,169,2442,1265,1177,113,63,46,794,304,213,344,185,160
1400000US36005007200,Census Tract 72,Bronx, New York,43,711,363,348,3511,1698,1813,223,114,77,1443,384,361,590,341,248
1400000US36005007400,Census Tract 74,Bronx, New York,43,432,222,210,2482,1085,1397,103,53,56,521,77,158,221,148,73
1400000US36005007600,Census Tract 76,Bronx, New York,43,425,241,184,3252,1657,1595,253,143,139,1255,388,255,689,394,297
1400000US36005007800,Census Tract 78,Bronx, New York,43,690,364,326,4065,1988,2077,262,138,135,1382,676,401,654,320,334
1400000US36005008400,Census Tract 84,Bronx, New York,43,293,59,234,1586,682,904,67,14,0,454,89,78,259,112,146
1400000US36005008600,Census Tract 86,Bronx, New York,43,521,335,186,2282,818,1464,134,86,59,331,212,288,468,135,332
1400000US36005009200,Census Tract 92,Bronx, New York,43,614,273,341,3420,1648,1772,121,54,54,783,387,406,540,255,285
1400000US36005009800,Census Tract 98,Bronx, New York,43,519,274,245,3077,1157,1920,54,28,22,363,29,171,305,143,161
1400000US36005021001,Census Tract 210.01,Bronx, New York,43,618,237,381,5462,2417,3045,125,48,170,273,87,192,415,145,268
1400000US36005021002,Census Tract 210.02,Bronx, New York,43,524,235,289,4763,2002,2761,92,41,62,691,208,248,395,218,177
1400000US36005021200,Census Tract 212,Bronx, New York,43,464,219,245,3687,1730,1957,14,7,16,0,85,131,313,230,84
1400000US36005021601,Census Tract 216.01,Bronx, New York,43,425,131,294,2311,856,1455,189,58,0,1486,92,132,518,182,335
1400000US36005021602,Census Tract 216.02,Bronx, New York,43,492,220,272,4242,1831,2411,297,133,157,2651,106,386,420,331,87
1400000US36005022200,Census Tract 222,Bronx, New York,43,273,97,176,1860,906,954,107,38,109,497,137,181,281,205,76
1400000US36005005902,Census Tract 59.02,Bronx, New York,44,324,193,131,1589,647,942,137,82,54,704,62,215,270,107,163
1400000US36005006100,Census Tract 61,Bronx, New York,44,338,216,122,2503,859,1644,36,23,20,0,66,28,195,45,150
1400000US36005014300,Census Tract 143,Bronx, New York,44,149,33,116,366,130,236,53,12,46,126,15,77,77,29,48
1400000US36005016500,Census Tract 165,Bronx, New York,44,358,225,133,574,257,317,110,69,27,281,17,21,102,57,45
1400000US36005016700,Census Tract 167,Bronx, New York,44,220,62,158,1122,458,664,28,8,0,199,67,183,99,57,42
1400000US36005017100,Census Tract 171,Bronx, New York,44,0,0,0,4,4,0,0,0,0,0,2,0,1,1,0
1400000US36005017300,Census Tract 173,Bronx, New York,44,838,564,274,3633,1580,2053,296,199,82,1671,466,585,527,316,209
1400000US36005017500,Census Tract 175,Bronx, New York,44,754,333,421,4068,1768,2300,242,107,198,822,357,619,923,401,522
1400000US36005017701,Census Tract 177.01,Bronx, New York,44,324,149,175,2287,1101,1186,128,59,56,1045,132,227,709,321,387
1400000US36005017702,Census Tract 177.02,Bronx, New York,44,483,294,189,2797,1365,1432,207,126,87,1066,186,334,587,298,291
1400000US36005017901,Census Tract 179.01,Bronx, New York,44,536,384,152,3195,1388,1807,204,146,81,0,600,643,479,253,228
1400000US36005017902,Census Tract 179.02,Bronx, New York,44,443,263,180,2065,850,1215,153,91,86,310,118,311,314,122,191
1400000US36005018101,Census Tract 181.01,Bronx, New York,44,431,274,157,2185,1013,1172,161,102,91,28,270,154,212,57,154
1400000US36005018102,Census Tract 181.02,Bronx, New York,44,455,213,242,3639,1913,1726,186,87,111,1325,547,471,706,293,414
1400000US36005018301,Census Tract 183.01,Bronx, New York,44,335,192,143,3008,1305,1703,40,23,30,0,191,279,400,193,208
1400000US36005018302,Census Tract 183.02,Bronx, New York,44,429,199,230,2334,1194,1140,195,91,88,1207,170,124,364,215,149
1400000US36005018900,Census Tract 189,Bronx, New York,44,942,557,385,4726,2377,2349,271,160,133,969,335,336,624,442,183
1400000US36005019300,Census Tract 193,Bronx, New York,44,512,284,228,2999,1133,1866,196,109,107,828,208,310,612,210,403
1400000US36005019500,Census Tract 195,Bronx, New York,44,550,239,311,4561,2083,2478,123,54,82,880,394,486,657,277,382
1400000US36005019700,Census Tract 197,Bronx, New York,44,1006,548,458,4316,1841,2475,371,202,201,1234,573,416,794,341,450
1400000US36005019900,Census Tract 199,Bronx, New York,44,1008,447,561,4594,1917,2677,341,151,215,1392,479,538,887,376,514
1400000US36005020100,Census Tract 201,Bronx, New York,44,591,332,259,2278,1124,1154,122,68,21,836,211,142,522,244,278
1400000US36005020501,Census Tract 205.01,Bronx, New York,44,614,259,355,3828,1382,2446,226,95,116,1520,160,428,785,261,523
1400000US36005020900,Census Tract 209,Bronx, New York,44,635,444,191,2634,1231,1403,215,151,66,856,217,154,385,143,241
1400000US36005021100,Census Tract 211,Bronx, New York,44,589,274,315,3130,1485,1645,223,104,125,1133,261,433,491,183,308
1400000US36005021302,Census Tract 213.02,Bronx, New York,44,551,303,248,3080,1467,1613,143,79,88,447,266,421,585,279,306
1400000US36005021900,Census Tract 219,Bronx, New York,44,201,90,111,752,350,402,19,9,14,54,37,103,114,36,78
1400000US36005022101,Census Tract 221.01,Bronx, New York,44,380,171,209,2332,1192,1140,226,102,90,1695,325,437,282,194,89
1400000US36005022102,Census Tract 221.02,Bronx, New York,44,435,171,264,2773,1131,1642,185,73,154,893,388,672,496,234,263
1400000US36005022300,Census Tract 223,Bronx, New York,44,599,332,267,3419,1670,1749,90,50,60,205,321,415,793,354,441
1400000US36005022500,Census Tract 225,Bronx, New York,44,979,565,414,4551,2122,2429,231,133,83,1297,465,685,910,545,362
1400000US36005022701,Census Tract 227.01,Bronx, New York,44,582,273,309,3392,1623,1769,90,42,27,726,268,453,621,367,255
1400000US36005022702,Census Tract 227.02,Bronx, New York,44,195,77,118,969,433,536,33,13,15,189,73,142,143,70,73
1400000US36005022703,Census Tract 227.03,Bronx, New York,44,235,70,165,1058,456,602,74,22,21,417,95,169,42,12,30
1400000US36005022901,Census Tract 229.01,Bronx, New York,44,645,422,223,3077,1496,1581,234,153,72,1338,289,457,317,132,183
1400000US36005022902,Census Tract 229.02,Bronx, New York,44,356,217,139,1751,650,1101,113,69,38,667,120,319,285,152,134
1400000US36005009000,Census Tract 90,Bronx, New York,45,516,342,174,1906,720,1186,213,141,77,679,114,196,309,122,186
1400000US36005009600,Census Tract 96,Bronx, New York,45,291,202,89,1403,656,747,58,40,21,157,78,121,108,25,83
1400000US36005011000,Census Tract 110,Bronx, New York,45,35,0,35,80,32,48,0,0,0,0,0,0,9,0,9
1400000US36005011800,Census Tract 118,Bronx, New York,45,1046,670,376,3326,1523,1803,3,2,2,0,38,112,313,139,173
1400000US36005013000,Census Tract 130,Bronx, New York,45,111,84,27,875,416,459,23,17,7,0,35,32,84,39,45
1400000US36005013200,Census Tract 132,Bronx, New York,45,608,364,244,4526,1916,2610,103,62,46,647,77,264,172,6,164
1400000US36005013800,Census Tract 138,Bronx, New York,45,186,111,75,2185,1113,1072,23,14,0,671,55,24,225,175,49
1400000US36005014400,Census Tract 144,Bronx, New York,45,501,283,218,3268,1296,1972,211,119,102,1170,137,243,595,279,316
1400000US36005015200,Census Tract 152,Bronx, New York,45,160,68,92,1793,790,1003,39,17,28,351,138,164,133,44,89
1400000US36005015800,Census Tract 158,Bronx, New York,45,116,50,66,907,500,407,13,6,16,14,91,43,88,49,39
1400000US36005016000,Census Tract 160,Bronx, New York,45,327,110,217,2854,1474,1380,51,17,59,277,22,86,166,83,83
1400000US36005016200,Census Tract 162,Bronx, New York,45,54,5,49,1241,505,736,0,0,0,0,44,58,158,72,86
1400000US36005016400,Census Tract 164,Bronx, New York,45,63,32,31,724,345,379,11,6,0,257,16,9,94,61,33
1400000US36005016600,Census Tract 166,Bronx, New York,45,139,98,41,1733,799,934,0,0,0,0,61,99,187,87,101
1400000US36005018400,Census Tract 184,Bronx, New York,45,336,178,158,2793,1266,1527,17,9,0,302,173,179,310,147,162
1400000US36005020200,Census Tract 202,Bronx, New York,45,152,87,65,1323,566,757,36,21,15,325,46,43,206,75,132
1400000US36005020400,Census Tract 204,Bronx, New York,45,345,167,178,1832,924,908,39,19,0,401,86,206,234,113,122
1400000US36005020601,Census Tract 206.01,Bronx, New York,45,387,230,157,1881,697,1184,32,19,14,132,52,135,295,126,170
1400000US36005026400,Census Tract 264,Bronx, New York,45,442,262,180,3643,1753,1890,27,16,19,0,128,60,364,172,195
1400000US36005026601,Census Tract 266.01,Bronx, New York,45,276,174,102,2342,1109,1233,2,1,0,47,30,194,347,147,199
1400000US36005026602,Census Tract 266.02,Bronx, New York,45,286,176,110,3822,1803,2019,56,34,35,0,144,299,348,178,168
1400000US36005027401,Census Tract 274.01,Bronx, New York,45,547,142,405,3559,1716,1843,0,0,0,0,94,186,246,77,168
1400000US36005027402,Census Tract 274.02,Bronx, New York,45,149,81,68,2568,1211,1357,15,8,11,74,59,179,282,88,194
1400000US36005028400,Census Tract 284,Bronx, New York,45,89,58,31,733,567,166,50,33,26,48,56,23,315,277,38
1400000US36005030000,Census Tract 300,Bronx, New York,45,385,146,239,4408,1980,2428,45,17,74,0,168,177,357,166,192
1400000US36005030200,Census Tract 302,Bronx, New York,45,693,335,358,7214,3171,4043,128,62,19,2215,140,287,671,279,392
1400000US36005045600,Census Tract 456,Bronx, New York,45,295,249,46,2137,932,1205,84,71,16,0,74,69,175,95,80
1400000US36005046201,Census Tract 462.01,Bronx, New York,45,1895,1183,712,19951,8223,11728,335,209,173,1377,493,844,1855,905,950
1400000US36005050400,Census Tract 504,Bronx, New York,45,0,0,0,0,0,0,0,0,0,0,0,0,0,0,0
1400000US36005051600,Census Tract 516,Bronx, New York,45,394,181,213,3305,1517,1788,0,0,0,0,61,72,334,190,145
1400000US36005005300,Census Tract 53,Bronx, New York,46,570,147,423,2007,854,1153,213,55,55,921,101,244,279,137,142
1400000US36005020502,Census Tract 205.02,Bronx, New York,46,250,109,141,1027,496,531,104,45,111,131,113,134,125,31,94
1400000US36005021301,Census Tract 213.01,Bronx, New York,46,198,81,117,762,350,412,71,29,61,189,79,60,175,45,130
1400000US36005021501,Census Tract 215.01,Bronx, New York,46,567,279,288,1873,789,1084,216,106,141,513,182,274,238,60,177
1400000US36005021502,Census Tract 215.02,Bronx, New York,46,811,429,382,3195,1207,1988,204,108,115,626,244,364,649,330,318
1400000US36005021700,Census Tract 217,Bronx, New York,46,534,236,298,3363,1587,1776,204,90,153,938,213,288,837,300,538
1400000US36005023100,Census Tract 231,Bronx, New York,46,113,57,56,865,465,400,19,10,19,0,75,89,125,61,64
1400000US36005023301,Census Tract 233.01,Bronx, New York,46,441,256,185,2991,1398,1593,75,44,54,0,287,382,544,338,205
1400000US36005023302,Census Tract 233.02,Bronx, New York,46,487,181,306,1622,579,1043,118,44,90,344,111,188,305,48,257
1400000US36005023501,Census Tract 235.01,Bronx, New York,46,415,275,140,2145,1028,1117,126,84,53,352,292,299,189,87,102
1400000US36005023502,Census Tract 235.02,Bronx, New York,46,678,461,217,3112,1483,1629,274,186,86,1304,482,428,622,245,376
1400000US36005023702,Census Tract 237.02,Bronx, New York,46,168,71,97,588,272,316,40,17,10,200,169,57,158,8,150
1400000US36005023703,Census Tract 237.03,Bronx, New York,46,489,335,154,2511,1023,1488,220,151,84,620,318,240,389,120,268
1400000US36005023704,Census Tract 237.04,Bronx, New York,46,487,273,214,2200,706,1494,212,119,99,884,264,252,565,94,471
1400000US36005024100,Census Tract 241,Bronx, New York,46,761,448,313,3315,1475,1840,260,153,99,1250,183,366,494,184,311
1400000US36005024300,Census Tract 243,Bronx, New York,46,588,398,190,3368,1394,1974,197,133,73,781,252,286,573,163,409
1400000US36005024501,Census Tract 245.01,Bronx, New York,46,782,213,569,2594,914,1680,63,17,80,150,204,307,480,168,311
1400000US36005024502,Census Tract 245.02,Bronx, New York,46,537,341,196,2495,1390,1105,206,131,95,509,272,320,347,215,130
1400000US36005024700,Census Tract 247,Bronx, New York,46,157,75,82,1325,713,612,36,17,17,323,149,60,197,78,119
1400000US36005024900,Census Tract 249,Bronx, New York,46,0,0,0,0,0,0,0,0,0,0,0,0,0,0,0
1400000US36005025100,Census Tract 251,Bronx, New York,46,1263,609,654,3839,1970,1869,344,166,177,1052,378,404,656,366,288
1400000US36005025700,Census Tract 257,Bronx, New York,46,196,116,80,1371,646,725,74,44,43,206,111,154,162,97,65
1400000US36005038100,Census Tract 381,Bronx, New York,46,676,257,419,3845,2040,1805,365,139,174,2369,384,406,496,153,343
1400000US36005038301,Census Tract 383.01,Bronx, New York,46,517,244,273,2305,932,1373,163,77,74,818,26,299,468,165,303
1400000US36005038302,Census Tract 383.02,Bronx, New York,46,678,260,418,2903,1151,1752,316,121,203,1321,257,307,630,173,457
1400000US36005039902,Census Tract 399.02,Bronx, New York,46,334,211,123,2630,1123,1507,126,80,54,726,261,393,576,341,234
1400000US36005031000,Census Tract 310,Bronx, New York,47,369,214,155,3418,1468,1950,31,18,22,0,189,193,396,189,209
1400000US36005034400,Census Tract 344,Bronx, New York,47,113,68,45,1199,648,551,9,5,6,0,97,52,221,184,37
1400000US36005034800,Census Tract 348,Bronx, New York,47,898,510,388,4216,1817,2399,246,140,88,1412,238,242,325,156,168
1400000US36005035600,Census Tract 356,Bronx, New York,47,224,145,79,1441,676,765,35,23,13,200,1,18,192,66,125
1400000US36005035800,Census Tract 358,Bronx, New York,47,793,396,397,5176,2221,2955,91,46,51,523,64,33,606,353,254
1400000US36005036400,Census Tract 364,Bronx, New York,47,358,113,245,1757,645,1112,102,32,160,200,81,113,248,130,118
1400000US36005036800,Census Tract 368,Bronx, New York,47,87,36,51,1227,429,798,12,5,17,0,19,30,94,42,52
1400000US36005037000,Census Tract 370,Bronx, New York,47,314,133,181,1770,789,981,43,18,35,166,81,63,242,115,128
1400000US36005037200,Census Tract 372,Bronx, New York,47,187,138,49,1679,788,891,102,75,26,1028,53,99,175,50,125
1400000US36005037400,Census Tract 374,Bronx, New York,47,359,130,229,1759,652,1107,165,60,100,830,160,126,183,34,149
1400000US36005037600,Census Tract 376,Bronx, New York,47,245,156,89,1556,656,900,21,13,12,0,87,107,182,122,60
1400000US36005037800,Census Tract 378,Bronx, New York,47,406,138,268,1633,622,1011,9,3,0,56,108,113,330,131,199
1400000US36005038000,Census Tract 380,Bronx, New York,47,269,143,126,2672,1039,1633,44,23,29,232,43,87,361,91,269
1400000US36005038200,Census Tract 382,Bronx, New York,47,231,137,94,1602,592,1010,96,57,51,375,39,107,266,55,211
1400000US36005038600,Census Tract 386,Bronx, New York,47,931,300,631,4436,1802,2634,327,105,333,1189,299,221,488,243,242
1400000US36005038800,Census Tract 388,Bronx, New York,47,292,144,148,1639,523,1116,50,25,9,454,22,64,185,98,88
1400000US36005039000,Census Tract 390,Bronx, New York,47,298,143,155,1758,767,991,74,35,73,79,42,0,264,52,211
1400000US36005039200,Census Tract 392,Bronx, New York,47,124,87,37,1177,524,653,34,24,14,0,75,37,189,42,147
1400000US36005039400,Census Tract 394,Bronx, New York,47,409,158,251,3015,1209,1806,94,36,54,721,204,206,359,169,191
1400000US36005039600,Census Tract 396,Bronx, New York,47,310,144,166,2115,896,1219,62,29,23,535,103,176,256,106,150
1400000US36005039800,Census Tract 398,Bronx, New York,47,317,118,199,2110,942,1168,42,16,71,0,121,160,120,88,33
1400000US36005040400,Census Tract 404,Bronx, New York,47,357,225,132,1827,750,1077,30,19,12,124,76,108,227,63,163
1400000US36005040600,Census Tract 406,Bronx, New York,47,421,243,178,2181,802,1379,105,61,59,294,93,125,277,92,186
1400000US36005040800,Census Tract 408,Bronx, New York,47,355,169,186,2306,1038,1268,55,26,0,683,156,131,360,171,189
1400000US36005041800,Census Tract 418,Bronx, New York,47,471,287,184,2498,1079,1419,58,35,14,490,99,219,230,101,129
1400000US36005042000,Census Tract 420,Bronx, New York,47,387,200,187,2263,976,1287,76,39,51,253,195,154,405,163,243
1400000US36005042200,Census Tract 422,Bronx, New York,47,202,40,162,2235,886,1349,30,6,0,413,132,70,224,145,80
1400000US36005042400,Census Tract 424,Bronx, New York,47,376,178,198,1892,909,983,60,28,37,257,89,34,235,123,112
1400000US36005042600,Census Tract 426,Bronx, New York,47,693,261,432,5244,2012,3232,123,46,53,1106,173,284,556,181,375
1400000US36005042800,Census Tract 428,Bronx, New York,47,177,80,97,1471,640,831,19,9,23,0,30,70,132,79,53
1400000US36005043000,Census Tract 430,Bronx, New York,47,310,175,135,2065,884,1181,70,40,31,458,104,168,190,115,74
1400000US36005043400,Census Tract 434,Bronx, New York,47,380,198,182,2509,1018,1491,82,43,52,344,91,183,344,172,171
1400000US36005043500,Census Tract 435,Bronx, New York,47,0,0,0,18,18,0,0,0,0,0,18,0,0,0,0
1400000US36005043600,Census Tract 436,Bronx, New York,47,251,107,144,1341,584,757,58,25,47,215,0,45,174,58,117
1400000US36005044200,Census Tract 442,Bronx, New York,47,424,155,269,2612,1117,1495,67,24,59,321,109,179,193,90,102
1400000US36005044400,Census Tract 444,Bronx, New York,47,398,224,174,2627,1052,1575,93,52,41,604,83,189,184,62,121
1400000US36005044800,Census Tract 448,Bronx, New York,47,176,76,100,1648,613,1035,34,15,45,0,7,47,69,37,33
1400000US36005044901,Census Tract 449.01,Bronx, New York,47,144,68,76,1370,594,776,4,2,0,73,23,8,105,39,67
1400000US36005044902,Census Tract 449.02,Bronx, New York,47,131,97,34,1484,651,833,23,17,5,349,47,127,50,13,38
1400000US36005045101,Census Tract 451.01,Bronx, New York,47,222,132,90,1107,498,609,56,33,18,356,4,7,9,9,0
1400000US36005045102,Census Tract 451.02,Bronx, New York,47,50,26,24,1365,808,557,0,0,0,0,36,12,22,10,12
1400000US36005045800,Census Tract 458,Bronx, New York,47,929,554,375,3299,964,2335,457,273,203,1382,148,418,732,350,383
1400000US36005046000,Census Tract 460,Bronx, New York,47,349,164,185,1704,729,975,64,30,33,322,76,92,196,104,92
1400000US36005046202,Census Tract 462.02,Bronx, New York,47,1123,257,866,4515,1860,2655,128,29,313,181,231,255,718,238,478
1400000US36005048400,Census Tract 484,Bronx, New York,47,380,176,204,2324,1047,1277,60,28,35,342,58,59,295,198,97
1400000US36005021800,Census Tract 218,Bronx, New York,48,440,199,241,3767,1759,2008,88,40,47,765,301,297,501,269,233
1400000US36005022000,Census Tract 220,Bronx, New York,48,315,178,137,672,295,377,124,70,39,358,107,65,79,9,70
1400000US36005024000,Census Tract 240,Bronx, New York,48,501,241,260,2323,1061,1262,158,76,116,446,106,138,546,281,264
1400000US36005033400,Census Tract 334,Bronx, New York,48,16,3,13,604,205,399,3,1,0,140,10,72,36,22,14
1400000US36005036100,Census Tract 361,Bronx, New York,48,800,354,446,3144,1100,2044,299,132,111,1487,163,511,692,195,497
1400000US36005036300,Census Tract 363,Bronx, New York,48,764,412,352,4535,2038,2497,219,118,120,1016,487,587,658,336,320
1400000US36005036501,Census Tract 365.01,Bronx, New York,48,485,286,199,2192,852,1340,150,88,47,903,271,189,460,88,373
1400000US36005036502,Census Tract 365.02,Bronx, New York,48,358,169,189,1245,557,688,90,42,31,408,98,103,339,138,201
1400000US36005036700,Census Tract 367,Bronx, New York,48,357,152,205,941,407,534,134,57,67,386,63,125,261,114,147
1400000US36005036901,Census Tract 369.01,Bronx, New York,48,267,151,116,1128,301,827,108,61,46,467,27,167,224,52,173
1400000US36005036902,Census Tract 369.02,Bronx, New York,48,213,132,81,1251,546,705,42,26,22,93,48,122,134,56,78
1400000US36005037100,Census Tract 371,Bronx, New York,48,445,139,306,2297,846,1451,107,33,125,374,266,234,319,63,255
1400000US36005037300,Census Tract 373,Bronx, New York,48,603,301,302,2412,991,1421,181,90,107,591,175,308,316,172,144
1400000US36005037504,Census Tract 375.04,Bronx, New York,48,482,237,245,2480,1032,1448,196,96,77,1225,276,358,568,289,278
1400000US36005037900,Census Tract 379,Bronx, New York,48,943,387,556,2131,863,1268,444,182,290,927,115,307,552,219,333
1400000US36005038500,Census Tract 385,Bronx, New York,48,653,306,347,2495,1262,1233,399,187,246,1307,262,301,546,184,363
1400000US36005038700,Census Tract 387,Bronx, New York,48,436,324,112,1723,935,788,123,91,25,768,211,194,252,144,108
1400000US36005038900,Census Tract 389,Bronx, New York,48,1094,521,573,2408,1137,1271,188,90,87,458,418,341,443,147,296
1400000US36005039100,Census Tract 391,Bronx, New York,48,918,498,420,3608,1671,1937,332,180,150,1324,444,482,704,341,362
1400000US36005039300,Census Tract 393,Bronx, New York,48,1045,507,538,4457,1799,2658,371,180,236,1235,473,635,981,342,638
1400000US36005039500,Census Tract 395,Bronx, New York,48,453,197,256,1890,868,1022,219,95,150,767,162,154,420,268,151
1400000US36005020000,Census Tract 200,Bronx, New York,49,406,188,218,3043,1454,1589,66,31,27,599,81,146,529,257,272
1400000US36005022401,Census Tract 224.01,Bronx, New York,49,264,87,177,1714,769,945,50,16,77,117,217,90,273,87,186
1400000US36005022403,Census Tract 224.03,Bronx, New York,49,299,171,128,2084,632,1452,118,68,57,684,110,155,246,46,200
1400000US36005022404,Census Tract 224.04,Bronx, New York,49,424,136,288,3002,1448,1554,55,18,0,573,98,225,228,88,138
1400000US36005022800,Census Tract 228,Bronx, New York,49,440,200,240,4249,1973,2276,35,16,20,319,276,496,510,223,289
1400000US36005023000,Census Tract 230,Bronx, New York,49,228,87,141,2058,895,1163,71,27,78,335,100,163,327,201,127
1400000US36005023200,Census Tract 232,Bronx, New York,49,246,114,132,1740,801,939,33,15,37,14,77,109,212,87,126
1400000US36005023600,Census Tract 236,Bronx, New York,49,214,94,120,1156,554,602,10,4,13,0,122,229,127,58,69
1400000US36005023800,Census Tract 238,Bronx, New York,49,283,189,94,1433,676,757,99,66,33,503,71,66,301,208,93
1400000US36005024400,Census Tract 244,Bronx, New York,49,196,86,110,1664,760,904,17,7,5,196,20,100,206,89,117
1400000US36005024600,Census Tract 246,Bronx, New York,49,255,36,219,1500,763,737,19,3,55,69,103,174,86,10,75
1400000US36005024800,Census Tract 248,Bronx, New York,49,205,96,109,2873,1312,1561,13,6,0,342,249,222,313,143,172
1400000US36005025000,Census Tract 250,Bronx, New York,49,306,184,122,1700,769,931,61,37,36,83,91,113,168,90,79
1400000US36005025200,Census Tract 252,Bronx, New York,49,264,200,64,1748,826,922,35,27,11,0,65,141,418,224,193
1400000US36005025400,Census Tract 254,Bronx, New York,49,66,46,20,1501,734,767,0,0,0,0,51,38,107,100,7
1400000US36005025600,Census Tract 256,Bronx, New York,49,93,39,54,1151,552,599,0,0,0,0,70,27,93,51,42
1400000US36005027600,Census Tract 276,Bronx, New York,49,0,0,0,17,10,7,0,0,0,0,4,0,0,0,0
1400000US36005028600,Census Tract 286,Bronx, New York,49,94,44,50,779,344,435,0,0,0,0,35,88,14,14,0
1400000US36005028800,Census Tract 288,Bronx, New York,49,166,79,87,2225,989,1236,11,5,0,280,144,171,65,47,19
1400000US36005029600,Census Tract 296,Bronx, New York,49,274,154,120,1710,760,950,56,31,44,0,125,69,51,51,0
1400000US36005031200,Census Tract 312,Bronx, New York,49,155,109,46,1287,642,645,15,11,3,252,108,75,85,48,37
1400000US36005031400,Census Tract 314,Bronx, New York,49,221,83,138,1672,823,849,18,7,0,217,72,144,155,69,86
1400000US36005031600,Census Tract 316,Bronx, New York,49,219,103,116,1472,703,769,12,6,0,152,101,76,54,25,30
1400000US36005031800,Census Tract 318,Bronx, New York,49,71,20,51,1643,824,819,20,6,51,0,79,106,135,88,46
1400000US36005032400,Census Tract 324,Bronx, New York,49,381,156,225,1881,678,1203,101,41,104,243,107,69,303,85,218
1400000US36005032600,Census Tract 326,Bronx, New York,49,382,159,223,2485,1218,1267,22,9,31,0,117,146,189,78,111
1400000US36005032800,Census Tract 328,Bronx, New York,49,491,231,260,2288,1015,1273,173,81,57,1073,71,190,247,144,102
1400000US36005033000,Census Tract 330,Bronx, New York,49,467,199,268,3657,1813,1844,91,39,28,954,149,302,468,292,175
1400000US36005033201,Census Tract 332.01,Bronx, New York,49,365,45,320,2630,1105,1525,33,4,121,132,69,95,505,298,206
1400000US36005033202,Census Tract 332.02,Bronx, New York,49,276,166,110,2178,862,1316,78,47,31,614,120,268,292,66,226
1400000US36005033600,Census Tract 336,Bronx, New York,49,650,344,306,4008,1816,2192,200,106,95,1218,439,272,649,272,377
1400000US36005033800,Census Tract 338,Bronx, New York,49,366,224,142,2338,1208,1130,95,58,30,790,134,120,248,100,148
1400000US36005034000,Census Tract 340,Bronx, New York,49,251,171,80,3087,1378,1709,8,5,0,309,128,115,367,214,154
1400000US36005034200,Census Tract 342,Bronx, New York,49,248,70,178,1080,525,555,62,18,158,0,102,103,63,41,22
1400000US36005035000,Census Tract 350,Bronx, New York,49,253,114,139,1119,507,612,72,32,56,209,11,31,88,9,79
1400000US36005036000,Census Tract 360,Bronx, New York,49,258,91,167,2439,1222,1217,3,1,0,44,72,119,246,122,124
1400000US36005026701,Census Tract 267.01,Bronx, New York,50,446,229,217,2181,838,1343,93,48,57,332,15,244,246,88,158
1400000US36005026702,Census Tract 267.02,Bronx, New York,50,940,554,386,3706,1705,2001,343,202,198,567,167,246,689,312,378
1400000US36005027300,Census Tract 273,Bronx, New York,50,931,409,522,5151,1982,3169,351,154,263,1432,256,605,737,279,456
1400000US36005027700,Census Tract 277,Bronx, New York,50,484,56,428,3527,1500,2027,107,12,222,642,342,470,459,152,306
1400000US36005027900,Census Tract 279,Bronx, New York,50,548,249,299,5217,2473,2744,115,52,120,261,260,307,574,349,225
1400000US36005028300,Census Tract 283,Bronx, New York,50,329,198,131,1938,795,1143,115,69,48,622,67,207,312,65,247
1400000US36005028500,Census Tract 285,Bronx, New York,50,376,255,121,2192,1088,1104,81,55,38,0,91,92,184,123,61
1400000US36005028700,Census Tract 287,Bronx, New York,50,257,149,108,2479,986,1493,37,21,19,253,120,99,169,70,99
1400000US36005028900,Census Tract 289,Bronx, New York,50,387,186,201,3281,1612,1669,55,26,35,374,280,269,436,264,172
1400000US36005029302,Census Tract 293.02,Bronx, New York,50,228,98,130,4236,1860,2376,24,10,32,0,56,64,216,126,88
1400000US36005029500,Census Tract 295,Bronx, New York,50,270,144,126,2991,1355,1636,1,1,1,0,41,46,60,26,34
1400000US36005029700,Census Tract 297,Bronx, New York,50,325,216,109,2581,1101,1480,0,0,0,0,19,90,93,43,50
1400000US36005030100,Census Tract 301,Bronx, New York,50,12,8,4,1216,511,705,1,1,0,304,50,97,77,28,49
1400000US36005030701,Census Tract 307.01,Bronx, New York,50,399,257,142,3734,1605,2129,12,8,4,105,47,106,37,26,11
1400000US36005031900,Census Tract 319,Bronx, New York,50,562,199,363,98,15,83,0,0,0,0,9,0,0,0,0
1400000US36005032300,Census Tract 323,Bronx, New York,50,152,37,115,3719,1663,2056,3,1,9,0,38,111,100,58,39
1400000US36005033500,Census Tract 335,Bronx, New York,50,456,230,226,1412,645,767,15,8,10,31,27,49,83,16,67
1400000US36005033700,Census Tract 337,Bronx, New York,50,251,107,144,1853,1016,837,13,6,17,0,45,8,39,5,33
1400000US36005034300,Census Tract 343,Bronx, New York,50,108,96,12,1244,703,541,33,29,4,0,32,42,98,65,33
1400000US36005034500,Census Tract 345,Bronx, New York,50,337,137,200,2624,1327,1297,0,0,0,0,62,29,144,98,45
1400000US36005035100,Census Tract 351,Bronx, New York,50,1125,614,511,1471,896,575,0,0,0,0,17,27,66,55,11
1400000US36005040900,Census Tract 409,Bronx, New York,50,332,130,202,2563,1136,1427,16,6,16,77,20,76,254,132,123
1400000US36005023900,Census Tract 239,Bronx, New York,52,746,340,406,4092,1588,2504,326,149,254,1138,497,596,827,322,506
1400000US36005025300,Census Tract 253,Bronx, New York,52,706,335,371,3554,1683,1871,129,61,90,458,234,284,601,274,327
1400000US36005025500,Census Tract 255,Bronx, New York,52,1059,408,651,4278,2159,2119,302,116,177,1253,404,483,595,279,314
1400000US36005026100,Census Tract 261,Bronx, New York,52,153,78,75,2440,1120,1320,25,13,0,813,71,55,285,169,116
1400000US36005026300,Census Tract 263,Bronx, New York,52,888,619,269,3699,1385,2314,253,176,86,755,334,472,607,265,340
1400000US36005026500,Census Tract 265,Bronx, New York,52,939,446,493,4243,1774,2469,279,132,190,921,367,506,488,197,294
1400000US36005026900,Census Tract 269,Bronx, New York,52,442,155,287,2089,930,1159,112,39,100,422,90,236,370,132,236
1400000US36005028100,Census Tract 281,Bronx, New York,52,307,175,132,3046,1285,1761,11,6,0,253,94,153,280,120,158
1400000US36005039700,Census Tract 397,Bronx, New York,52,2711,1312,1399,905,447,458,8,4,0,5,65,76,81,16,65
1400000US36005039901,Census Tract 399.01,Bronx, New York,52,754,403,351,3228,1660,1568,286,153,171,826,520,350,700,272,426
1400000US36005040100,Census Tract 401,Bronx, New York,52,549,154,395,2855,1178,1677,106,30,87,520,299,297,545,218,327
1400000US36005040302,Census Tract 403.02,Bronx, New York,52,386,149,237,2063,835,1228,140,54,49,949,114,291,322,147,176
1400000US36005040303,Census Tract 403.03,Bronx, New York,52,731,376,355,2285,1052,1233,270,139,135,818,76,129,363,190,173
1400000US36005040304,Census Tract 403.04,Bronx, New York,52,567,341,226,2038,1098,940,354,213,142,1262,223,150,267,148,119
1400000US36005040501,Census Tract 405.01,Bronx, New York,52,483,259,224,2182,979,1203,143,77,77,526,125,277,325,141,184
1400000US36005040502,Census Tract 405.02,Bronx, New York,52,816,320,496,2803,1249,1554,244,96,147,841,144,390,720,443,277
1400000US36005040701,Census Tract 407.01,Bronx, New York,52,536,308,228,2036,854,1182,151,87,87,295,162,296,316,105,210
1400000US36005040702,Census Tract 407.02,Bronx, New York,52,531,298,233,3723,1591,2132,106,60,36,961,218,279,491,111,379
1400000US36005041100,Census Tract 411,Bronx, New York,52,236,127,109,1697,817,880,51,27,27,295,138,126,154,91,63
1400000US36005041300,Census Tract 413,Bronx, New York,52,767,356,411,4981,2372,2609,287,133,188,1504,275,470,618,294,324
1400000US36005041500,Census Tract 415,Bronx, New York,52,749,417,332,3351,1583,1768,142,79,46,848,245,166,426,177,249
1400000US36005041900,Census Tract 419,Bronx, New York,52,676,370,306,3747,1766,1981,125,68,74,442,191,263,536,274,261
1400000US36005042100,Census Tract 421,Bronx, New York,52,626,298,328,3974,1869,2105,207,99,85,1574,396,352,441,142,299
1400000US36005042300,Census Tract 423,Bronx, New York,52,557,236,321,2486,1088,1398,157,67,65,845,132,266,169,124,46
1400000US36005042500,Census Tract 425,Bronx, New York,52,837,522,315,3892,1845,2047,216,135,109,432,199,309,487,212,274
1400000US36005042901,Census Tract 429.01,Bronx, New York,52,283,136,147,1806,768,1038,91,44,61,430,117,213,294,138,157
1400000US36005042902,Census Tract 429.02,Bronx, New York,52,356,165,191,2203,909,1294,126,58,83,623,123,258,414,175,239
1400000US36005043100,Census Tract 431,Bronx, New York,52,1149,598,551,6178,2666,3512,316,164,126,2008,605,499,643,200,443
1400000US36061030900,Census Tract 309,Manhattan, New York,52,850,375,475,5261,1855,3406,134,59,128,363,347,433,731,137,596
1400000US36047030000,Census Tract 300,Brooklyn, New York,60,122,48,74,2277,1174,1103,0,0,0,0,130,275,526,366,160
1400000US36047030200,Census Tract 302,Brooklyn, New York,60,310,161,149,2840,1510,1330,57,30,0,1088,384,315,520,279,242
1400000US36047030400,Census Tract 304,Brooklyn, New York,60,250,89,161,2958,1451,1507,37,13,67,0,199,276,541,292,250
1400000US36047030600,Census Tract 306,Brooklyn, New York,60,94,30,64,1495,743,752,38,12,9,794,150,176,164,90,74
1400000US36047030800,Census Tract 308,Brooklyn, New York,60,181,139,42,1340,638,702,6,5,2,0,123,98,129,70,59
1400000US36047032600,Census Tract 326,Brooklyn, New York,60,904,489,415,4196,1771,2425,272,147,139,1091,213,335,919,450,470
1400000US36047032800,Census Tract 328,Brooklyn, New York,60,442,189,253,2146,932,1214,126,54,66,652,113,211,569,241,328
1400000US36047033000,Census Tract 330,Brooklyn, New York,60,426,278,148,2882,1104,1778,167,109,41,1752,92,153,571,247,324
1400000US36047033600,Census Tract 336,Brooklyn, New York,60,244,126,118,3155,1546,1609,63,33,52,186,73,14,88,19,71
1400000US36047034000,Census Tract 340,Brooklyn, New York,60,136,77,59,1931,752,1179,64,36,20,1244,118,255,373,198,174
1400000US36047034200,Census Tract 342,Brooklyn, New York,60,597,400,197,3897,1388,2509,144,96,63,316,103,321,1091,364,730
1400000US36047034800,Census Tract 348,Brooklyn, New York,60,110,60,50,1530,901,629,13,7,11,0,183,82,304,202,103
1400000US36047035000,Census Tract 350,Brooklyn, New York,60,291,127,164,2463,1027,1436,12,5,8,91,44,72,135,68,67
1400000US36047035200,Census Tract 352,Brooklyn, New York,60,5,0,5,1145,418,727,5,0,0,1145,39,161,218,116,102
1400000US36047035400,Census Tract 354,Brooklyn, New York,60,205,77,128,4386,1930,2456,52,20,86,0,23,98,250,131,120
1400000US36047035601,Census Tract 356.01,Brooklyn, New York,60,114,0,114,2258,889,1369,0,0,0,0,0,30,41,21,21
1400000US36047035602,Census Tract 356.02,Brooklyn, New York,60,270,106,164,4388,1802,2586,14,6,22,0,70,176,316,114,202
1400000US36047036001,Census Tract 360.01,Brooklyn, New York,60,213,105,108,2549,1081,1468,7,3,0,166,85,78,145,45,100
1400000US36047036002,Census Tract 360.02,Brooklyn, New York,60,316,142,174,3015,1079,1936,10,5,0,172,74,128,63,28,35
1400000US36047036200,Census Tract 362,Brooklyn, New York,60,377,282,95,2205,1013,1192,48,36,16,0,119,203,313,177,137
1400000US36047036400,Census Tract 364,Brooklyn, New York,60,322,150,172,1456,712,744,49,23,55,9,64,80,67,23,44
1400000US36047036600,Census Tract 366,Brooklyn, New York,60,420,174,246,2841,1446,1395,115,48,108,452,226,144,247,124,121
1400000US36047037000,Census Tract 370,Brooklyn, New York,60,234,99,135,2861,1313,1548,23,10,0,486,75,63,232,152,79
1400000US36047037401,Census Tract 374.01,Brooklyn, New York,60,307,216,91,3276,1511,1765,60,42,17,721,141,99,95,53,41
1400000US36047037402,Census Tract 374.02,Brooklyn, New York,60,363,178,185,3305,1458,1847,0,0,0,0,125,164,317,141,175
1400000US36047038200,Census Tract 382,Brooklyn, New York,60,571,259,312,3687,1599,2088,203,92,100,1419,302,470,903,312,593
1400000US36047038600,Census Tract 386,Brooklyn, New York,60,179,35,144,2048,1067,981,0,0,0,0,122,185,289,165,124
1400000US36047061002,Census Tract 610.02,Brooklyn, New York,60,240,116,124,3203,1475,1728,0,0,0,0,7,36,102,52,52
1400000US36047061003,Census Tract 610.03,Brooklyn, New York,60,233,121,112,745,355,390,73,38,68,0,0,28,6,6,0
1400000US36047038800,Census Tract 388,Brooklyn, New York,61,402,204,198,2347,1236,1111,8,4,0,94,70,68,153,59,93
1400000US36047039000,Census Tract 390,Brooklyn, New York,61,173,106,67,1466,644,822,34,21,18,132,28,37,163,82,80
1400000US36047039200,Census Tract 392,Brooklyn, New York,61,113,59,54,1805,727,1078,21,11,0,702,93,124,72,30,42
1400000US36047039400,Census Tract 394,Brooklyn, New York,61,247,132,115,1605,791,814,30,16,0,419,68,66,96,78,18
1400000US36047039600,Census Tract 396,Brooklyn, New York,61,120,66,54,1146,577,569,25,14,0,531,43,40,92,28,64
1400000US36047039800,Census Tract 398,Brooklyn, New York,61,154,90,64,1732,783,949,16,9,11,0,113,189,189,49,140
1400000US36047040200,Census Tract 402,Brooklyn, New York,61,94,73,21,1895,1016,879,44,34,7,1895,118,199,354,194,161
1400000US36047041401,Census Tract 414.01,Brooklyn, New York,61,76,39,37,917,403,514,0,0,0,0,12,23,22,5,17
1400000US36047041402,Census Tract 414.02,Brooklyn, New York,61,166,60,106,1180,557,623,0,0,0,0,20,7,44,8,36
1400000US36047041600,Census Tract 416,Brooklyn, New York,61,244,155,89,1469,649,820,60,38,26,231,93,112,134,48,86
1400000US36047041800,Census Tract 418,Brooklyn, New York,61,168,58,110,1092,478,614,6,2,11,0,31,75,111,66,45
1400000US36047042000,Census Tract 420,Brooklyn, New York,61,250,138,112,1070,562,508,28,15,12,124,12,30,185,112,73
1400000US36047042200,Census Tract 422,Brooklyn, New York,61,184,77,107,2117,1055,1062,29,12,25,218,63,109,368,208,161
1400000US36047054600,Census Tract 546,Brooklyn, New York,61,446,241,205,3265,1569,1696,60,33,51,0,46,124,225,105,119
1400000US36047054800,Census Tract 548,Brooklyn, New York,61,249,132,117,1547,691,856,5,3,4,0,75,64,235,73,162
1400000US36047055000,Census Tract 550,Brooklyn, New York,61,279,136,143,2261,1028,1233,35,17,37,0,102,72,156,83,74
1400000US36047055200,Census Tract 552,Brooklyn, New York,61,352,211,141,2526,1183,1343,23,14,5,268,108,94,205,108,95
1400000US36047055400,Census Tract 554,Brooklyn, New York,61,435,246,189,2435,1144,1291,42,24,22,168,144,127,114,37,77
1400000US36047055600,Census Tract 556,Brooklyn, New York,61,377,267,110,2215,1100,1115,10,7,4,0,58,49,188,78,112
1400000US36047055800,Census Tract 558,Brooklyn, New York,61,192,115,77,1562,814,748,54,32,13,690,14,33,159,107,53
1400000US36047056000,Census Tract 560,Brooklyn, New York,61,262,102,160,2334,1163,1171,32,12,16,322,30,32,112,90,23
1400000US36047056200,Census Tract 562,Brooklyn, New York,61,191,103,88,1062,484,578,10,5,9,0,15,27,44,12,32
1400000US36047056400,Census Tract 564,Brooklyn, New York,61,36,24,12,1458,706,752,0,0,0,0,56,40,34,24,10
1400000US36047056600,Census Tract 566,Brooklyn, New York,61,342,282,60,1901,826,1075,31,26,3,570,88,34,95,34,61
1400000US36047056800,Census Tract 568,Brooklyn, New York,61,16,16,0,1139,500,639,0,0,0,0,0,28,51,29,22
1400000US36047057000,Census Tract 570,Brooklyn, New York,61,202,94,108,2525,1144,1381,0,0,0,0,149,152,174,59,115
1400000US36047057200,Census Tract 572,Brooklyn, New York,61,625,390,235,2858,950,1908,185,115,79,646,111,78,503,112,391
1400000US36047057400,Census Tract 574,Brooklyn, New York,61,365,141,224,1749,815,934,27,10,0,212,96,216,164,69,95
1400000US36047057600,Census Tract 576,Brooklyn, New York,61,381,181,200,2211,979,1232,41,20,45,0,143,159,332,96,235
1400000US36047057800,Census Tract 578,Brooklyn, New York,61,333,118,215,2184,1187,997,34,12,9,295,97,94,166,99,67
1400000US36047058000,Census Tract 580,Brooklyn, New York,61,249,124,125,2417,1036,1381,87,43,77,213,211,305,145,42,104
1400000US36047058200,Census Tract 582,Brooklyn, New York,61,184,81,103,1909,1051,858,16,7,10,149,180,91,200,133,66
1400000US36047058400,Census Tract 584,Brooklyn, New York,61,120,95,25,2650,1355,1295,8,6,2,0,186,171,183,80,104
1400000US36047058600,Census Tract 586,Brooklyn, New York,61,176,77,99,1627,765,862,10,4,0,164,172,143,242,117,125
1400000US36047058800,Census Tract 588,Brooklyn, New York,61,286,228,58,2302,991,1311,36,29,9,0,40,63,85,36,50
1400000US36047059000,Census Tract 590,Brooklyn, New York,61,131,22,109,1457,661,796,26,4,20,294,72,151,95,38,57
1400000US36047059200,Census Tract 592,Brooklyn, New York,61,303,173,130,3022,1450,1572,8,4,6,0,170,208,245,157,90
1400000US36047059401,Census Tract 594.01,Brooklyn, New York,61,483,203,280,5365,2478,2887,16,7,0,306,302,196,338,248,89
1400000US36047059402,Census Tract 594.02,Brooklyn, New York,61,388,224,164,3317,1537,1780,14,8,10,0,77,107,216,114,101
1400000US36047059600,Census Tract 596,Brooklyn, New York,61,96,80,16,1809,753,1056,0,0,0,0,5,40,96,32,64
1400000US36047059800,Census Tract 598,Brooklyn, New York,61,387,266,121,2212,910,1302,17,12,8,0,11,52,93,14,79
1400000US36047060000,Census Tract 600,Brooklyn, New York,61,345,118,227,4102,1882,2220,1,0,2,0,83,91,242,58,186
1400000US36047060600,Census Tract 606,Brooklyn, New York,61,212,145,67,1968,966,1002,0,0,0,0,53,60,102,40,63
1400000US36047060800,Census Tract 608,Brooklyn, New York,61,187,120,67,2226,1035,1191,0,0,0,0,77,10,82,12,71
1400000US36047061004,Census Tract 610.04,Brooklyn, New York,61,179,67,112,4197,1897,2300,0,0,0,0,135,161,264,138,127
1400000US36047061200,Census Tract 612,Brooklyn, New York,61,45,11,34,776,393,383,0,0,0,0,12,0,21,8,13
1400000US36047061600,Census Tract 616,Brooklyn, New York,61,117,79,38,1341,581,760,19,13,6,247,51,88,83,39,44
1400000US36047062000,Census Tract 620,Brooklyn, New York,61,65,25,40,1429,735,694,0,0,0,0,0,9,33,23,10
1400000US36047062200,Census Tract 622,Brooklyn, New York,61,109,45,64,2381,1120,1261,0,0,0,0,39,42,376,223,153
1400000US36047062600,Census Tract 626,Brooklyn, New York,61,206,108,98,1779,823,956,0,0,0,0,29,37,155,104,51
1400000US36047063200,Census Tract 632,Brooklyn, New York,61,68,34,34,1141,542,599,1,1,1,0,14,26,68,15,53
1400000US36047063800,Census Tract 638,Brooklyn, New York,61,213,173,40,1282,608,674,5,4,0,160,45,61,71,48,23
1400000US36047064000,Census Tract 640,Brooklyn, New York,61,231,125,106,1281,657,624,0,0,0,0,31,7,102,57,46
1400000US36047064400,Census Tract 644,Brooklyn, New York,61,164,21,143,1514,663,851,0,0,0,0,11,74,97,91,6
1400000US36047066600,Census Tract 666,Brooklyn, New York,61,0,0,0,0,0,0,0,0,0,0,0,0,0,0,0
1400000US36047016800,Census Tract 168,Brooklyn, New York,62,67,53,14,1234,636,598,4,3,1,0,21,68,72,32,39
1400000US36047017000,Census Tract 170,Brooklyn, New York,62,216,142,74,2655,1408,1247,0,0,0,0,165,175,271,149,122
1400000US36047017200,Census Tract 172,Brooklyn, New York,62,380,186,194,1961,871,1090,98,48,42,586,105,184,108,63,44
1400000US36047017400,Census Tract 174,Brooklyn, New York,62,43,9,34,1405,722,683,0,0,0,0,175,53,143,56,87
1400000US36047017600,Census Tract 176,Brooklyn, New York,62,176,119,57,1346,591,755,12,8,6,0,35,105,174,82,91
1400000US36047017800,Census Tract 178,Brooklyn, New York,62,228,66,162,1681,771,910,0,0,0,0,144,187,220,116,105
1400000US36047018000,Census Tract 180,Brooklyn, New York,62,211,133,78,2099,998,1101,33,21,13,269,212,145,405,141,264
1400000US36047018200,Census Tract 182,Brooklyn, New York,62,251,124,127,2119,1006,1113,37,18,38,0,137,278,504,311,193
1400000US36047018400,Census Tract 184,Brooklyn, New York,62,200,100,100,1327,666,661,32,16,20,159,90,57,129,80,49
1400000US36047018600,Census Tract 186,Brooklyn, New York,62,105,45,60,1370,598,772,3,1,0,69,62,76,153,73,81
1400000US36047018800,Census Tract 188,Brooklyn, New York,62,235,117,118,2148,1025,1123,0,0,0,0,103,158,329,195,133
1400000US36047019000,Census Tract 190,Brooklyn, New York,62,325,181,144,3416,1671,1745,94,52,39,1069,426,389,519,304,215
1400000US36047019200,Census Tract 192,Brooklyn, New York,62,183,103,80,1433,761,672,32,18,22,72,76,97,288,133,155
1400000US36047019400,Census Tract 194,Brooklyn, New York,62,239,100,139,2902,1379,1523,103,43,68,1126,507,647,287,131,155
1400000US36047024600,Census Tract 246,Brooklyn, New York,62,202,116,86,1867,867,1000,0,0,0,0,125,219,174,110,64
1400000US36047024800,Census Tract 248,Brooklyn, New York,62,327,178,149,1743,830,913,69,38,48,141,54,144,136,67,69
1400000US36047025000,Census Tract 250,Brooklyn, New York,62,204,39,165,1422,643,779,14,3,0,121,115,168,131,86,45
1400000US36047025200,Census Tract 252,Brooklyn, New York,62,561,312,249,4031,1797,2234,175,97,85,1117,397,315,508,228,277
1400000US36047025400,Census Tract 254,Brooklyn, New York,62,305,134,171,2487,1292,1195,34,15,11,363,289,301,321,199,121
1400000US36047025600,Census Tract 256,Brooklyn, New York,62,313,203,110,2425,1139,1286,12,8,0,264,154,251,550,313,237
1400000US36047025800,Census Tract 258,Brooklyn, New York,62,536,337,199,3059,1470,1589,221,139,131,0,215,281,343,179,164
1400000US36047026000,Census Tract 260,Brooklyn, New York,62,406,171,235,2367,1067,1300,30,13,25,121,256,358,206,117,88
1400000US36047026200,Census Tract 262,Brooklyn, New York,62,261,134,127,1653,845,808,0,0,0,0,104,97,207,138,68
1400000US36047026400,Census Tract 264,Brooklyn, New York,62,362,185,177,3188,1632,1556,32,16,3,523,149,300,475,273,204
1400000US36047026600,Census Tract 266,Brooklyn, New York,62,229,95,134,2456,1067,1389,17,7,11,165,212,251,251,132,119
1400000US36047026800,Census Tract 268,Brooklyn, New York,62,418,284,134,2769,1456,1313,21,14,10,0,210,263,396,301,96
1400000US36047027000,Census Tract 270,Brooklyn, New York,62,140,36,104,1489,646,843,26,7,0,372,59,67,179,73,106
1400000US36047027200,Census Tract 272,Brooklyn, New York,62,265,78,187,2120,1000,1120,44,13,19,409,80,155,333,145,187
1400000US36047027400,Census Tract 274,Brooklyn, New York,62,199,146,53,1812,947,865,0,0,0,0,132,192,252,148,104
1400000US36047027600,Census Tract 276,Brooklyn, New York,62,223,104,119,2624,1209,1415,31,14,26,176,255,317,365,187,177
1400000US36047027800,Census Tract 278,Brooklyn, New York,62,217,109,108,1981,843,1138,0,0,0,0,99,126,260,118,141
1400000US36047028000,Census Tract 280,Brooklyn, New York,62,195,95,100,1247,646,601,53,26,56,0,75,96,64,36,27
1400000US36047028200,Census Tract 282,Brooklyn, New York,62,244,153,91,2017,840,1177,59,37,29,222,64,187,309,184,124
1400000US36047028400,Census Tract 284,Brooklyn, New York,62,188,83,105,2588,1317,1271,0,0,0,0,248,264,388,270,119
1400000US36047028600,Census Tract 286,Brooklyn, New York,62,444,162,282,3425,1544,1881,0,0,0,0,181,181,336,86,248
1400000US36047028800,Census Tract 288,Brooklyn, New York,62,220,139,81,1925,854,1071,26,16,2,524,195,215,293,161,132
1400000US36047029000,Census Tract 290,Brooklyn, New York,62,320,101,219,2417,1124,1293,35,11,0,387,139,154,389,153,237
1400000US36047029200,Census Tract 292,Brooklyn, New York,62,207,118,89,1349,604,745,24,14,18,0,81,140,254,136,118
1400000US36047029400,Census Tract 294,Brooklyn, New York,62,91,23,68,1792,846,946,22,6,38,237,121,170,366,251,115
1400000US36047029600,Census Tract 296,Brooklyn, New York,62,335,220,115,3046,1389,1657,14,9,0,372,56,108,247,142,106
1400000US36047029800,Census Tract 298,Brooklyn, New York,62,292,158,134,2580,1210,1370,9,5,8,0,169,206,472,209,262
1400000US36047031400,Census Tract 314,Brooklyn, New York,62,227,102,125,3389,1462,1927,0,0,0,0,155,168,397,143,252
1400000US36047040000,Census Tract 400,Brooklyn, New York,62,318,203,115,2166,1030,1136,14,9,8,0,231,272,513,235,278
1400000US36047040400,Census Tract 404,Brooklyn, New York,62,149,20,129,1812,872,940,0,0,0,0,88,135,299,197,102
1400000US36047040600,Census Tract 406,Brooklyn, New York,62,122,28,94,2315,1104,1211,24,6,0,590,130,130,252,123,131
1400000US36047040800,Census Tract 408,Brooklyn, New York,62,384,213,171,2295,1129,1166,43,24,35,0,75,191,335,182,152
1400000US36047041000,Census Tract 410,Brooklyn, New York,62,164,59,105,1314,624,690,0,0,0,0,42,78,139,64,75
1400000US36047041200,Census Tract 412,Brooklyn, New York,62,261,92,169,1893,773,1120,0,0,0,0,84,169,341,130,211
1400000US36047042400,Census Tract 424,Brooklyn, New York,62,211,99,112,2382,1335,1047,33,15,11,488,222,119,369,170,200
1400000US36047042600,Census Tract 426,Brooklyn, New York,62,381,254,127,3070,1469,1601,46,31,18,243,184,279,510,250,261
1400000US36047042800,Census Tract 428,Brooklyn, New York,62,268,90,178,2880,1275,1605,25,8,0,403,77,212,251,106,144
1400000US36047043000,Census Tract 430,Brooklyn, New York,62,259,171,88,2286,1017,1269,110,73,51,261,153,165,338,122,216
1400000US36047043200,Census Tract 432,Brooklyn, New York,62,325,80,245,2826,1378,1448,82,20,28,842,258,346,379,183,195
1400000US36047043400,Census Tract 434,Brooklyn, New York,62,391,235,156,2633,1312,1321,72,43,48,0,104,104,184,94,89
1400000US36047043600,Census Tract 436,Brooklyn, New York,62,374,221,153,2915,1418,1497,36,21,25,0,234,278,414,262,153
1400000US36047043800,Census Tract 438,Brooklyn, New York,62,207,129,78,1780,870,910,8,5,5,0,78,83,336,170,167
1400000US36047044000,Census Tract 440,Brooklyn, New York,62,300,160,140,1552,737,815,32,17,28,0,37,86,102,73,29
1400000US36047063600,Census Tract 636,Brooklyn, New York,63,69,56,13,884,378,506,7,6,2,0,7,17,41,34,7
1400000US36047064600,Census Tract 646,Brooklyn, New York,63,222,166,56,1398,727,671,21,16,7,0,0,0,87,45,41
1400000US36047064800,Census Tract 648,Brooklyn, New York,63,140,58,82,1353,679,674,69,29,61,429,4,35,127,49,78
1400000US36047065000,Census Tract 650,Brooklyn, New York,63,246,124,122,1014,433,581,14,7,14,0,35,40,135,94,41
1400000US36047065200,Census Tract 652,Brooklyn, New York,63,149,63,86,887,436,451,0,0,0,0,0,5,34,4,30
1400000US36047065400,Census Tract 654,Brooklyn, New York,63,108,7,101,1173,596,577,0,0,0,0,16,10,161,65,96
1400000US36047065600,Census Tract 656,Brooklyn, New York,63,197,89,108,1200,539,661,25,11,16,133,17,7,113,39,74
1400000US36047065800,Census Tract 658,Brooklyn, New York,63,113,80,33,1310,536,774,9,6,4,0,19,19,41,36,5
1400000US36047066000,Census Tract 660,Brooklyn, New York,63,80,45,35,1261,587,674,17,10,10,144,27,18,73,73,0
1400000US36047066200,Census Tract 662,Brooklyn, New York,63,162,139,23,1105,495,610,26,22,4,0,12,8,113,63,50
1400000US36047067000,Census Tract 670,Brooklyn, New York,63,133,49,84,1992,918,1074,54,20,60,450,38,55,125,80,46
1400000US36047067200,Census Tract 672,Brooklyn, New York,63,239,78,161,981,494,487,37,12,0,226,137,74,124,25,99
1400000US36047067400,Census Tract 674,Brooklyn, New York,63,207,100,107,1338,586,752,49,24,14,450,45,42,98,48,50
1400000US36047067600,Census Tract 676,Brooklyn, New York,63,250,115,135,1411,611,800,67,31,41,334,11,43,76,56,20
1400000US36047067800,Census Tract 678,Brooklyn, New York,63,295,103,192,1949,922,1027,13,5,0,133,12,50,144,49,96
1400000US36047068000,Census Tract 680,Brooklyn, New York,63,273,180,93,1058,458,600,91,60,47,0,69,114,68,53,15
1400000US36047068200,Census Tract 682,Brooklyn, New York,63,368,221,147,2112,1052,1060,17,10,11,0,11,40,144,82,61
1400000US36047068600,Census Tract 686,Brooklyn, New York,63,108,32,76,1039,430,609,0,0,0,0,37,17,82,0,82
1400000US36047068800,Census Tract 688,Brooklyn, New York,63,166,131,35,1251,529,722,25,20,7,0,35,61,143,108,34
1400000US36047069000,Census Tract 690,Brooklyn, New York,63,169,81,88,1060,478,582,18,9,0,217,11,16,35,5,30
1400000US36047069200,Census Tract 692,Brooklyn, New York,63,259,142,117,1436,584,852,35,19,11,270,45,109,118,58,60
1400000US36047069601,Census Tract 696.01,Brooklyn, New York,63,290,115,175,2742,1238,1504,14,6,0,219,87,99,88,32,57
1400000US36047069602,Census Tract 696.02,Brooklyn, New York,63,708,498,210,4225,2092,2133,38,27,16,0,33,51,169,113,58
1400000US36047069800,Census Tract 698,Brooklyn, New York,63,157,64,93,887,449,438,5,2,0,48,11,39,97,39,58
1400000US36047070000,Census Tract 700,Brooklyn, New York,63,369,136,233,1259,623,636,65,24,38,233,51,14,31,27,4
1400000US36047070201,Census Tract 702.01,Brooklyn, New York,63,466,133,333,4699,2026,2673,0,0,0,0,53,51,150,91,56
1400000US36047070202,Census Tract 702.02,Brooklyn, New York,63,0,0,0,63,27,36,0,0,0,0,0,0,54,27,27
1400000US36047070600,Census Tract 706,Brooklyn, New York,63,387,152,235,2021,972,1049,7,3,11,0,67,86,63,40,23
1400000US36047072000,Census Tract 720,Brooklyn, New York,63,312,196,116,1247,477,770,54,34,32,0,0,76,126,46,80
1400000US36047072200,Census Tract 722,Brooklyn, New York,63,264,102,162,2276,1009,1267,36,14,0,505,86,70,191,113,79
1400000US36047072400,Census Tract 724,Brooklyn, New York,63,120,88,32,1467,581,886,21,15,4,412,13,38,175,97,78
1400000US36047072800,Census Tract 728,Brooklyn, New York,63,351,166,185,2811,1256,1555,34,16,21,228,36,103,287,165,121
1400000US36047073000,Census Tract 730,Brooklyn, New York,63,355,243,112,1810,839,971,22,15,10,0,33,78,221,126,94
1400000US36047073200,Census Tract 732,Brooklyn, New York,63,325,154,171,1639,632,1007,0,0,0,0,24,0,207,70,137
1400000US36047073400,Census Tract 734,Brooklyn, New York,63,257,120,137,1430,660,770,0,0,0,0,59,48,167,107,61
1400000US36047073600,Census Tract 736,Brooklyn, New York,63,346,104,242,2315,989,1326,20,6,46,0,23,125,199,56,145
1400000US36047073800,Census Tract 738,Brooklyn, New York,63,337,142,195,2390,1188,1202,47,20,33,282,4,95,98,8,90
1400000US36047074000,Census Tract 740,Brooklyn, New York,63,289,175,114,2485,1088,1397,46,28,30,0,30,80,288,106,182
1400000US36047074200,Census Tract 742,Brooklyn, New York,63,361,228,133,1989,879,1110,37,23,0,553,68,30,109,68,42
1400000US36047074400,Census Tract 744,Brooklyn, New York,63,101,72,29,1146,591,555,25,18,10,0,14,10,36,19,16
1400000US36047074800,Census Tract 748,Brooklyn, New York,63,151,43,108,1174,514,660,0,0,0,0,14,19,43,43,0
1400000US36047077600,Census Tract 776,Brooklyn, New York,63,334,211,123,2862,1118,1744,22,14,13,0,68,108,232,92,141
1400000US36047093200,Census Tract 932,Brooklyn, New York,63,74,7,67,1027,525,502,18,2,0,276,18,12,41,21,20
1400000US36047094402,Census Tract 944.02,Brooklyn, New York,63,374,107,267,1553,472,1081,21,6,52,0,66,109,182,63,119
1400000US36047011000,Census Tract 110,Brooklyn, New York,66,357,202,155,1576,933,643,88,50,40,366,275,205,318,193,126
1400000US36047011200,Census Tract 112,Brooklyn, New York,66,681,370,311,3898,1782,2116,65,35,35,288,520,383,745,205,540
1400000US36047011400,Census Tract 114,Brooklyn, New York,66,339,179,160,2659,1371,1288,44,23,17,415,243,240,279,149,131
1400000US36047011600,Census Tract 116,Brooklyn, New York,66,302,125,177,3133,1551,1582,96,40,52,1043,495,658,639,344,296
1400000US36047011800,Census Tract 118,Brooklyn, New York,66,246,106,140,1451,723,728,77,33,48,425,220,259,239,134,105
1400000US36047021400,Census Tract 214,Brooklyn, New York,66,376,102,274,1108,541,567,31,8,24,89,70,129,285,167,118
1400000US36047021600,Census Tract 216,Brooklyn, New York,66,366,257,109,2134,1100,1034,140,98,56,156,274,213,216,171,45
1400000US36047021800,Census Tract 218,Brooklyn, New York,66,332,160,172,1988,981,1007,61,29,39,288,135,202,199,154,44
1400000US36047022000,Census Tract 220,Brooklyn, New York,66,692,308,384,2200,1134,1066,148,66,92,425,174,274,231,119,112
1400000US36047022200,Census Tract 222,Brooklyn, New York,66,477,254,223,2055,1069,986,49,26,18,267,134,91,335,166,169
1400000US36047022400,Census Tract 224,Brooklyn, New York,66,700,268,432,2486,1125,1361,228,87,210,564,209,225,415,203,214
1400000US36047022600,Census Tract 226,Brooklyn, New York,66,243,121,122,1571,837,734,62,31,44,233,254,240,239,148,91
1400000US36047022800,Census Tract 228,Brooklyn, New York,66,500,287,213,1655,940,715,126,72,90,38,165,169,232,142,90
1400000US36047023000,Census Tract 230,Brooklyn, New York,66,443,300,143,2103,926,1177,167,113,75,147,145,147,360,166,194
1400000US36047023200,Census Tract 232,Brooklyn, New York,66,558,308,250,2977,1572,1405,134,74,42,988,329,139,253,149,103
1400000US36047023400,Census Tract 234,Brooklyn, New York,66,674,336,338,2277,999,1278,100,50,47,357,59,101,182,106,75
1400000US36047023600,Census Tract 236,Brooklyn, New York,66,744,330,414,2482,1187,1295,42,18,34,89,169,199,283,137,148
1400000US36047023800,Census Tract 238,Brooklyn, New York,66,505,211,294,2181,1035,1146,48,20,24,229,120,141,255,120,136
1400000US36047024000,Census Tract 240,Brooklyn, New York,66,519,292,227,2772,1437,1335,199,112,81,1161,247,243,269,125,146
1400000US36047024200,Census Tract 242,Brooklyn, New York,66,211,124,87,1514,677,837,55,32,32,156,82,56,185,91,94
1400000US36047024400,Census Tract 244,Brooklyn, New York,66,395,253,142,1927,987,940,109,70,61,0,129,53,318,154,164
1400000US36047044200,Census Tract 442,Brooklyn, New York,66,324,119,205,1405,745,660,0,0,0,0,57,0,98,47,52
1400000US36047044400,Census Tract 444,Brooklyn, New York,66,492,277,215,1960,916,1044,27,15,21,0,61,95,92,42,50
1400000US36047044600,Census Tract 446,Brooklyn, New York,66,195,165,30,1452,724,728,57,48,10,0,86,103,222,125,97
1400000US36047044800,Census Tract 448,Brooklyn, New York,66,84,48,36,1238,615,623,22,13,16,0,51,35,45,7,38
1400000US36047045000,Census Tract 450,Brooklyn, New York,66,122,101,21,438,190,248,33,27,7,0,21,32,20,0,20
1400000US36047045200,Census Tract 452,Brooklyn, New York,66,238,164,74,1514,755,759,0,0,0,0,20,54,118,83,35
1400000US36047045400,Census Tract 454,Brooklyn, New York,66,325,185,140,931,485,446,33,19,25,0,4,5,39,28,11
1400000US36047045600,Census Tract 456,Brooklyn, New York,66,472,297,175,1400,608,792,12,7,7,0,29,69,78,39,40
1400000US36047045800,Census Tract 458,Brooklyn, New York,66,112,80,32,805,397,408,12,9,5,0,12,42,3,0,3
1400000US36047046201,Census Tract 462.01,Brooklyn, New York,66,378,216,162,1549,742,807,28,16,21,0,103,67,112,53,59
1400000US36047046202,Census Tract 462.02,Brooklyn, New York,66,143,78,65,965,514,451,42,23,35,0,27,32,110,86,24
1400000US36047046400,Census Tract 464,Brooklyn, New York,66,329,207,122,1154,586,568,0,0,0,0,37,7,63,43,20
1400000US36047046800,Census Tract 468,Brooklyn, New York,66,60,20,40,936,353,583,15,5,14,187,6,45,55,41,14
1400000US36047047000,Census Tract 470,Brooklyn, New York,66,283,191,92,1558,748,810,43,29,17,136,15,73,126,73,53
1400000US36047047200,Census Tract 472,Brooklyn, New York,66,366,282,84,1531,751,780,66,51,16,219,48,51,222,134,88
1400000US36047047400,Census Tract 474,Brooklyn, New York,66,237,97,140,1721,905,816,55,23,43,308,36,51,157,97,59
1400000US36047047600,Census Tract 476,Brooklyn, New York,66,426,210,216,1849,842,1007,114,56,108,78,83,61,176,86,89
1400000US36047048200,Census Tract 482,Brooklyn, New York,66,664,385,279,3275,1481,1794,148,86,66,668,213,170,400,169,231
1400000US36047048600,Census Tract 486,Brooklyn, New York,66,378,142,236,1842,928,914,93,35,43,523,126,125,184,101,83
1400000US36047048800,Census Tract 488,Brooklyn, New York,66,438,196,242,2387,1125,1262,74,33,58,267,158,153,203,104,98
1400000US36047049000,Census Tract 490,Brooklyn, New York,66,404,232,172,3894,1801,2093,41,23,7,701,52,113,202,104,96
1400000US36047049200,Census Tract 492,Brooklyn, New York,66,219,125,94,2050,1035,1015,15,9,0,328,202,120,107,51,56
1400000US36047049400,Census Tract 494,Brooklyn, New York,66,483,275,208,4103,1824,2279,121,69,61,788,224,271,185,82,103
1400000US36047049600,Census Tract 496,Brooklyn, New York,66,327,146,181,2797,1422,1375,72,32,89,0,226,166,344,154,190
1400000US36047049800,Census Tract 498,Brooklyn, New York,66,517,184,333,2953,1406,1547,36,13,47,89,148,193,301,194,108
1400000US36047072600,Census Tract 726,Brooklyn, New York,67,229,155,74,1633,666,967,35,24,13,155,30,48,52,28,25
1400000US36047078000,Census Tract 780,Brooklyn, New York,67,258,87,171,1735,773,962,35,12,20,253,10,21,40,1,39
1400000US36047078200,Census Tract 782,Brooklyn, New York,67,505,181,324,2827,1235,1592,136,49,109,653,56,115,206,98,107
1400000US36047078400,Census Tract 784,Brooklyn, New York,67,269,112,157,1812,917,895,11,5,15,0,21,8,188,112,77
1400000US36047078600,Census Tract 786,Brooklyn, New York,67,584,330,254,2793,1216,1577,111,63,27,835,89,162,240,143,98
1400000US36047081400,Census Tract 814,Brooklyn, New York,67,263,119,144,1863,710,1153,58,26,33,401,43,115,110,69,42
1400000US36047081600,Census Tract 816,Brooklyn, New York,67,268,105,163,1881,837,1044,90,35,42,728,67,69,265,134,132
1400000US36047081800,Census Tract 818,Brooklyn, New York,67,631,222,409,2909,1207,1702,126,44,101,506,101,102,332,106,226
1400000US36047082000,Census Tract 820,Brooklyn, New York,67,920,398,522,3469,1395,2074,198,86,131,652,86,141,382,159,222
1400000US36047082200,Census Tract 822,Brooklyn, New York,67,570,327,243,4529,1901,2628,146,84,79,725,127,318,525,300,226
1400000US36047082400,Census Tract 824,Brooklyn, New York,67,445,260,185,2782,1285,1497,74,43,45,164,50,213,267,94,174
1400000US36047082600,Census Tract 826,Brooklyn, New York,67,725,372,353,3561,1394,2167,206,106,125,748,118,245,442,269,171
1400000US36047082800,Census Tract 828,Brooklyn, New York,67,431,180,251,2418,1156,1262,59,25,49,232,20,42,201,92,109
1400000US36047083000,Census Tract 830,Brooklyn, New York,67,551,285,266,3810,1572,2238,61,32,54,42,134,72,606,255,351
1400000US36047083200,Census Tract 832,Brooklyn, New York,67,326,213,113,1563,701,862,37,24,15,111,42,39,156,109,48
1400000US36047083400,Census Tract 834,Brooklyn, New York,67,192,75,117,1439,738,701,65,25,9,725,27,74,161,77,84
1400000US36047083600,Census Tract 836,Brooklyn, New York,67,243,128,115,1433,661,772,16,8,11,50,31,26,122,66,56
1400000US36047083800,Census Tract 838,Brooklyn, New York,67,397,222,175,1740,774,966,122,68,96,0,6,59,162,116,46
1400000US36047084000,Census Tract 840,Brooklyn, New York,67,124,64,60,1815,783,1032,26,13,8,514,52,36,220,130,90
1400000US36047084600,Census Tract 846,Brooklyn, New York,67,122,86,36,1462,587,875,0,0,0,0,20,13,86,51,35
1400000US36047084800,Census Tract 848,Brooklyn, New York,67,361,210,151,1257,526,731,122,71,80,92,42,42,137,73,64
1400000US36047085000,Census Tract 850,Brooklyn, New York,67,109,64,45,936,293,643,10,6,7,0,4,0,59,14,45
1400000US36047085200,Census Tract 852,Brooklyn, New York,67,0,0,0,0,0,0,0,0,0,0,0,0,0,0,0
1400000US36047085400,Census Tract 854,Brooklyn, New York,67,219,80,139,1376,592,784,13,5,23,0,18,38,45,19,26
1400000US36047085600,Census Tract 856,Brooklyn, New York,67,313,132,181,2440,815,1625,34,14,0,459,0,37,142,50,93
1400000US36047085800,Census Tract 858,Brooklyn, New York,67,171,113,58,1764,719,1045,20,13,10,0,22,20,108,69,38
1400000US36047086000,Census Tract 860,Brooklyn, New York,67,221,103,118,2292,880,1412,66,31,49,447,107,181,133,43,89
1400000US36047086200,Census Tract 862,Brooklyn, New York,67,505,173,332,1956,728,1228,49,17,29,200,85,117,41,7,36
1400000US36047086400,Census Tract 864,Brooklyn, New York,67,242,134,108,1889,919,970,18,10,14,0,90,72,53,22,31
1400000US36047086600,Census Tract 866,Brooklyn, New York,67,310,121,189,2169,837,1332,71,28,53,425,18,143,295,153,141
1400000US36047086800,Census Tract 868,Brooklyn, New York,67,286,62,224,1962,773,1189,11,2,0,96,127,92,177,149,27
1400000US36047087000,Census Tract 870,Brooklyn, New York,67,255,102,153,1928,795,1133,84,34,48,656,72,97,64,0,63
1400000US36047087200,Census Tract 872,Brooklyn, New York,67,181,108,73,2073,929,1144,31,18,7,568,31,31,153,116,38
1400000US36047088200,Census Tract 882,Brooklyn, New York,67,558,244,314,4265,1876,2389,55,24,54,175,150,177,461,165,294
1400000US36047088400,Census Tract 884,Brooklyn, New York,67,644,216,428,3298,1388,1910,109,37,109,416,75,50,620,301,317
1400000US36047088600,Census Tract 886,Brooklyn, New York,67,577,249,328,2793,1115,1678,55,24,53,128,72,161,335,76,258
1400000US36047088800,Census Tract 888,Brooklyn, New York,67,278,108,170,2826,1258,1568,64,25,54,497,174,149,268,171,97
1400000US36047093000,Census Tract 930,Brooklyn, New York,67,147,24,123,1836,934,902,0,0,0,0,72,44,127,52,74
1400000US36047093400,Census Tract 934,Brooklyn, New York,67,199,136,63,1845,802,1043,46,31,16,351,13,65,85,40,45
1400000US36047093600,Census Tract 936,Brooklyn, New York,67,265,162,103,1229,518,711,76,46,41,132,17,28,34,4,30
1400000US36047093800,Census Tract 938,Brooklyn, New York,67,263,113,150,1531,656,875,17,7,0,173,40,111,110,53,57
1400000US36047094401,Census Tract 944.01,Brooklyn, New York,67,390,281,109,2168,892,1276,66,47,22,199,35,23,167,99,69
1400000US36047094600,Census Tract 946,Brooklyn, New York,67,128,87,41,1668,797,871,0,0,0,0,6,135,158,81,77
1400000US36047096000,Census Tract 960,Brooklyn, New York,67,0,0,0,0,0,0,0,0,0,0,0,0,0,0,0
1400000US36047109800,Census Tract 1098,Brooklyn, New York,67,244,105,139,1263,583,680,66,28,45,290,35,27,293,119,174
1400000US36047002200,Census Tract 22,Brooklyn, New York,68,316,191,125,3201,1588,1613,73,44,28,794,357,321,554,318,235
1400000US36047003000,Census Tract 30,Brooklyn, New York,68,130,54,76,1362,692,670,0,0,0,0,14,22,20,9,11
1400000US36047003400,Census Tract 34,Brooklyn, New York,68,251,140,111,2309,974,1335,68,38,54,0,34,76,150,44,105
1400000US36047003600,Census Tract 36,Brooklyn, New York,68,393,176,217,3071,1442,1629,86,39,63,494,65,171,209,87,122
1400000US36047003800,Census Tract 38,Brooklyn, New York,68,171,115,56,1202,507,695,37,25,18,0,5,5,49,0,49
1400000US36047004400,Census Tract 44,Brooklyn, New York,68,177,108,69,1901,837,1064,0,0,0,0,23,74,118,29,88
1400000US36047004600,Census Tract 46,Brooklyn, New York,68,122,57,65,805,307,498,0,0,0,0,53,10,10,10,0
1400000US36047005000,Census Tract 50,Brooklyn, New York,68,156,57,99,1818,909,909,0,0,0,0,11,19,18,18,1
1400000US36047005201,Census Tract 52.01,Brooklyn, New York,68,80,36,44,1458,437,1021,0,0,0,0,35,83,117,17,100
1400000US36047005202,Census Tract 52.02,Brooklyn, New York,68,135,135,0,2035,979,1056,17,17,0,0,10,0,106,76,30
1400000US36047005400,Census Tract 54,Brooklyn, New York,68,176,104,72,2649,1186,1463,0,0,0,0,7,59,217,164,53
1400000US36047005601,Census Tract 56.01,Brooklyn, New York,68,145,63,82,2225,1015,1210,0,0,0,0,8,22,73,25,48
1400000US36047005602,Census Tract 56.02,Brooklyn, New York,68,79,68,11,1322,596,726,0,0,0,0,36,187,52,29,22
1400000US36047005800,Census Tract 58,Brooklyn, New York,68,239,131,108,2765,1268,1497,9,5,7,0,67,75,88,25,63
1400000US36047006000,Census Tract 60,Brooklyn, New York,68,225,105,120,1871,955,916,15,7,0,234,118,70,64,48,15
1400000US36047006200,Census Tract 62,Brooklyn, New York,68,187,79,108,1928,896,1032,17,7,23,0,0,43,83,16,67
1400000US36047006400,Census Tract 64,Brooklyn, New York,68,330,165,165,2980,1431,1549,42,21,14,507,120,108,256,142,116
1400000US36047006600,Census Tract 66,Brooklyn, New York,68,221,122,99,2674,1206,1468,83,46,67,0,122,115,163,101,62
1400000US36047006800,Census Tract 68,Brooklyn, New York,68,462,182,280,3358,1469,1889,92,36,65,601,264,281,437,154,283
1400000US36047007000,Census Tract 70,Brooklyn, New York,68,256,159,97,2129,964,1165,6,4,0,132,42,141,109,51,57
1400000US36047012000,Census Tract 120,Brooklyn, New York,68,145,47,98,951,474,477,0,0,0,0,275,308,50,28,22
1400000US36047012200,Census Tract 122,Brooklyn, New York,68,590,338,252,3002,1566,1436,168,96,80,726,442,419,453,218,237
1400000US36047012600,Census Tract 126,Brooklyn, New York,68,307,207,100,1849,918,931,36,24,14,148,170,272,240,90,150
1400000US36047012801,Census Tract 128.01,Brooklyn, New York,68,175,59,116,1549,686,863,59,20,24,627,120,152,446,191,255
1400000US36047013000,Census Tract 130,Brooklyn, New York,68,520,316,204,3273,1505,1768,49,30,21,272,158,255,340,105,235
1400000US36047013200,Census Tract 132,Brooklyn, New York,68,159,102,57,1306,633,673,49,31,4,939,133,157,255,94,161
1400000US36047013400,Census Tract 134,Brooklyn, New York,68,426,194,232,2757,1221,1536,0,0,0,0,82,190,138,31,108
1400000US36047013600,Census Tract 136,Brooklyn, New York,68,364,198,166,2799,1208,1591,54,29,23,456,114,72,176,87,91
1400000US36047013800,Census Tract 138,Brooklyn, New York,68,223,152,71,2328,1223,1105,0,0,0,0,94,93,233,150,82
1400000US36047014000,Census Tract 140,Brooklyn, New York,68,248,147,101,1456,684,772,75,44,46,115,80,76,84,24,60
1400000US36047014200,Census Tract 142,Brooklyn, New York,68,303,123,180,2187,1035,1152,37,15,48,48,77,99,199,76,123
1400000US36047014800,Census Tract 148,Brooklyn, New York,68,46,25,21,847,401,446,0,0,0,0,0,8,20,20,0
1400000US36047015000,Census Tract 150,Brooklyn, New York,68,189,67,122,1439,571,868,62,22,91,141,5,63,213,79,134
1400000US36047015200,Census Tract 152,Brooklyn, New York,68,178,107,71,1924,1046,878,2,1,1,0,113,75,148,100,48
1400000US36047015400,Census Tract 154,Brooklyn, New York,68,0,0,0,0,0,0,0,0,0,0,0,0,0,0,0
1400000US36047016000,Census Tract 160,Brooklyn, New York,68,298,103,195,2815,1346,1469,52,18,11,664,40,137,245,124,120
1400000US36047016200,Census Tract 162,Brooklyn, New York,68,139,59,80,1794,914,880,0,0,0,0,15,30,45,20,25
1400000US36047016400,Census Tract 164,Brooklyn, New York,68,214,154,60,527,293,234,16,12,0,141,15,14,20,20,0
1400000US36047016600,Census Tract 166,Brooklyn, New York,68,191,70,121,1643,815,828,11,4,19,0,20,61,64,35,29
1400000US36047019600,Census Tract 196,Brooklyn, New York,68,486,325,161,3109,1470,1639,87,58,43,0,319,369,339,179,161
1400000US36047019800,Census Tract 198,Brooklyn, New York,68,229,92,137,1276,679,597,14,6,21,0,23,85,93,65,28
1400000US36047020000,Census Tract 200,Brooklyn, New York,68,358,288,70,1368,616,752,119,96,26,274,147,143,129,78,50
1400000US36047020200,Census Tract 202,Brooklyn, New York,68,146,38,108,1392,660,732,0,0,0,0,102,142,72,57,16
1400000US36047020400,Census Tract 204,Brooklyn, New York,68,76,19,57,1269,562,707,0,0,0,0,11,75,65,54,11
1400000US36047020600,Census Tract 206,Brooklyn, New York,68,191,127,64,1662,869,793,0,0,0,0,116,127,55,45,10
1400000US36047020800,Census Tract 208,Brooklyn, New York,68,202,72,130,2055,1043,1012,8,3,0,127,215,212,181,77,103
1400000US36047021000,Census Tract 210,Brooklyn, New York,68,404,256,148,3047,1495,1552,38,24,15,268,356,334,350,172,177
1400000US36047021200,Census Tract 212,Brooklyn, New York,68,476,229,247,2864,1266,1598,90,43,51,498,398,547,318,139,181
1400000US36047092000,Census Tract 920,Brooklyn, New York,69,274,126,148,1614,681,933,62,28,39,316,37,53,371,116,255
1400000US36047095000,Census Tract 950,Brooklyn, New York,69,484,236,248,1786,722,1064,65,32,68,0,78,138,77,56,21
1400000US36047095400,Census Tract 954,Brooklyn, New York,69,491,275,216,2803,1114,1689,79,44,42,336,74,59,205,78,128
1400000US36047095600,Census Tract 956,Brooklyn, New York,69,622,331,291,2671,1060,1611,151,80,44,927,94,187,195,45,148
1400000US36047095800,Census Tract 958,Brooklyn, New York,69,187,104,83,2122,1097,1025,42,23,0,1074,114,90,172,113,58
1400000US36047096200,Census Tract 962,Brooklyn, New York,69,189,110,79,1077,502,575,63,37,29,313,15,87,46,27,19
1400000US36047096400,Census Tract 964,Brooklyn, New York,69,337,198,139,1652,845,807,51,30,15,345,28,24,147,79,68
1400000US36047096600,Census Tract 966,Brooklyn, New York,69,380,235,145,1435,620,815,49,30,23,119,46,33,154,81,73
1400000US36047096800,Census Tract 968,Brooklyn, New York,69,196,62,134,1078,448,630,6,2,13,0,6,48,29,11,18
1400000US36047097000,Census Tract 970,Brooklyn, New York,69,143,58,85,1055,287,768,22,9,25,62,22,39,52,29,23
1400000US36047097400,Census Tract 974,Brooklyn, New York,69,249,97,152,2517,999,1518,77,30,49,763,77,222,352,155,197
1400000US36047098200,Census Tract 982,Brooklyn, New York,69,637,272,365,2481,740,1741,154,66,93,578,44,77,581,171,409
1400000US36047098400,Census Tract 984,Brooklyn, New York,69,200,123,77,1324,607,717,9,6,0,155,75,71,118,29,89
1400000US36047098600,Census Tract 986,Brooklyn, New York,69,320,122,198,2132,861,1271,15,6,0,162,49,76,205,88,116
1400000US36047098800,Census Tract 988,Brooklyn, New York,69,362,144,218,2212,1044,1168,35,14,0,356,37,79,265,116,150
1400000US36047099000,Census Tract 990,Brooklyn, New York,69,101,66,35,1028,410,618,0,0,0,0,0,47,134,40,94
1400000US36047099200,Census Tract 992,Brooklyn, New York,69,170,79,91,1088,446,642,41,19,47,0,17,56,30,18,12
1400000US36047099400,Census Tract 994,Brooklyn, New York,69,215,145,70,1196,559,637,41,28,9,393,16,37,65,52,13
1400000US36047099600,Census Tract 996,Brooklyn, New York,69,349,152,197,2214,1030,1184,7,3,0,80,50,76,179,96,83
1400000US36047099800,Census Tract 998,Brooklyn, New York,69,353,204,149,2483,1009,1474,56,32,17,549,43,57,67,21,46
1400000US36047100400,Census Tract 1004,Brooklyn, New York,69,432,224,208,1630,636,994,26,13,24,0,5,22,16,16,0
1400000US36047100600,Census Tract 1006,Brooklyn, New York,69,169,95,74,1804,830,974,30,17,12,366,94,63,121,68,53
1400000US36047100800,Census Tract 1008,Brooklyn, New York,69,209,111,98,1331,604,727,47,25,41,0,22,30,87,64,23
1400000US36047101000,Census Tract 1010,Brooklyn, New York,69,427,318,109,1344,654,690,71,53,24,0,28,24,58,42,16
1400000US36047101200,Census Tract 1012,Brooklyn, New York,69,267,164,103,1440,695,745,20,12,8,112,16,44,75,30,45
1400000US36047101400,Census Tract 1014,Brooklyn, New York,69,234,139,95,1419,556,863,0,0,0,0,37,0,87,40,47
1400000US36047101600,Census Tract 1016,Brooklyn, New York,69,62,30,32,1017,370,647,17,8,18,0,41,39,64,20,44
1400000US36047101800,Census Tract 1018,Brooklyn, New York,69,137,56,81,1214,622,592,30,12,43,0,0,23,53,8,46
1400000US36047102000,Census Tract 1020,Brooklyn, New York,69,212,107,105,1444,650,794,12,6,12,0,18,21,53,16,38
1400000US36047102200,Census Tract 1022,Brooklyn, New York,69,195,97,98,1296,478,818,27,13,27,0,66,64,34,3,31
1400000US36047102400,Census Tract 1024,Brooklyn, New York,69,116,58,58,1048,413,635,8,4,8,0,12,41,59,26,33
1400000US36047102600,Census Tract 1026,Brooklyn, New York,69,516,158,358,1607,680,927,98,30,0,440,29,68,137,51,86
1400000US36047102800,Census Tract 1028,Brooklyn, New York,69,177,98,79,1065,473,592,75,42,38,377,29,37,48,11,37
1400000US36047103400,Census Tract 1034,Brooklyn, New York,69,504,155,349,1988,666,1322,170,52,63,809,148,89,370,133,237
1400000US36047046000,Census Tract 460,Brooklyn, New York,70,344,127,217,2199,1170,1029,77,28,31,598,9,80,194,125,68
1400000US36047047800,Census Tract 478,Brooklyn, New York,70,655,336,319,2135,1080,1055,70,36,38,201,204,141,226,148,78
1400000US36047048000,Census Tract 480,Brooklyn, New York,70,190,86,104,2042,988,1054,27,12,11,353,109,180,208,102,106
1400000US36047048400,Census Tract 484,Brooklyn, New York,70,468,273,195,2859,1405,1454,56,33,31,192,200,179,392,208,185
1400000US36047050600,Census Tract 506,Brooklyn, New York,70,759,293,466,3577,1646,1931,264,102,207,1030,212,297,426,280,147
1400000US36047050801,Census Tract 508.01,Brooklyn, New York,70,601,262,339,2366,976,1390,66,29,46,208,163,95,282,119,163
1400000US36047050803,Census Tract 508.03,Brooklyn, New York,70,366,228,138,1714,738,976,149,93,64,547,11,102,159,59,101
1400000US36047050804,Census Tract 508.04,Brooklyn, New York,70,738,400,338,4277,2042,2235,152,82,73,834,261,201,449,214,235
1400000US36047051001,Census Tract 510.01,Brooklyn, New York,70,459,244,215,2133,906,1227,80,42,37,378,32,60,224,90,135
1400000US36047051002,Census Tract 510.02,Brooklyn, New York,70,452,142,310,2969,1415,1554,67,21,57,392,160,149,422,263,159
1400000US36047051200,Census Tract 512,Brooklyn, New York,70,808,376,432,3992,1499,2493,179,83,190,128,106,207,471,199,274
1400000US36047051400,Census Tract 514,Brooklyn, New York,70,619,294,325,4771,2130,2641,61,29,50,234,377,475,534,256,280
1400000US36047051601,Census Tract 516.01,Brooklyn, New York,70,838,265,573,3380,1475,1905,161,51,0,950,260,191,365,112,253
1400000US36047051602,Census Tract 516.02,Brooklyn, New York,70,311,44,267,2338,907,1431,56,8,0,491,86,135,180,95,86
1400000US36047051800,Census Tract 518,Brooklyn, New York,70,524,315,209,2680,1183,1497,97,58,54,193,66,165,174,39,136
1400000US36047052000,Census Tract 520,Brooklyn, New York,70,536,277,259,2899,1461,1438,114,59,66,481,199,197,223,80,142
1400000US36047052600,Census Tract 526,Brooklyn, New York,70,533,244,289,2885,1138,1747,103,47,66,470,145,243,208,112,98
1400000US36047052800,Census Tract 528,Brooklyn, New York,70,196,73,123,1248,602,646,26,10,17,162,17,43,52,33,20
1400000US36047053000,Census Tract 530,Brooklyn, New York,70,406,252,154,1956,937,1019,21,13,0,266,73,109,203,87,117
1400000US36047053200,Census Tract 532,Brooklyn, New York,70,141,98,43,2001,1030,971,27,19,12,0,80,115,322,279,44
1400000US36047053400,Census Tract 534,Brooklyn, New York,70,265,153,112,2342,971,1371,0,0,0,0,61,84,159,57,103
1400000US36047053800,Census Tract 538,Brooklyn, New York,70,390,281,109,3256,1608,1648,28,20,6,387,135,152,215,103,112
1400000US36047054200,Census Tract 542,Brooklyn, New York,70,571,317,254,2570,1072,1498,92,51,74,0,28,97,164,111,52
1400000US36047054400,Census Tract 544,Brooklyn, New York,70,413,180,233,2321,1134,1187,23,10,30,0,53,46,93,36,57
1400000US36047064200,Census Tract 642,Brooklyn, New York,70,284,112,172,1617,788,829,24,10,18,113,39,42,71,47,24
1400000US36047074600,Census Tract 746,Brooklyn, New York,70,141,108,33,1082,489,593,0,0,0,0,30,29,51,51,0
1400000US36047075000,Census Tract 750,Brooklyn, New York,70,272,174,98,1657,838,819,68,44,27,338,0,37,164,91,73
1400000US36047075200,Census Tract 752,Brooklyn, New York,70,163,74,89,609,288,321,23,10,28,0,0,0,63,36,27
1400000US36047075400,Census Tract 754,Brooklyn, New York,70,134,82,52,855,439,416,10,6,6,0,7,0,5,0,5
1400000US36047075600,Census Tract 756,Brooklyn, New York,70,190,81,109,1146,560,586,6,3,8,0,10,49,60,16,44
1400000US36047075800,Census Tract 758,Brooklyn, New York,70,155,105,50,1098,534,564,16,11,0,351,0,6,52,23,29
1400000US36047076000,Census Tract 760,Brooklyn, New York,70,263,158,105,1725,864,861,79,47,41,295,40,63,50,24,26
1400000US36047076200,Census Tract 762,Brooklyn, New York,70,461,184,277,2861,1400,1461,36,14,20,237,160,175,252,169,80
1400000US36047076400,Census Tract 764,Brooklyn, New York,70,472,296,176,2486,1079,1407,88,55,43,226,137,225,298,158,142
1400000US36047076600,Census Tract 766,Brooklyn, New York,70,331,223,108,1366,545,821,74,50,0,936,42,26,96,32,63
1400000US36047076800,Census Tract 768,Brooklyn, New York,70,508,243,265,1980,967,1013,61,29,10,388,47,119,172,111,61
1400000US36047077000,Census Tract 770,Brooklyn, New York,70,271,169,102,1793,764,1029,30,19,6,351,39,61,140,91,48
1400000US36047077200,Census Tract 772,Brooklyn, New York,70,414,264,150,2173,987,1186,21,13,0,304,26,101,63,38,26
1400000US36047077400,Census Tract 774,Brooklyn, New York,70,409,134,275,1905,814,1091,34,11,70,0,36,88,152,66,86
1400000US36047078800,Census Tract 788,Brooklyn, New York,70,249,115,134,2211,964,1247,82,38,16,1121,97,128,206,101,105
1400000US36047079000,Census Tract 790,Brooklyn, New York,70,478,237,241,3664,1668,1996,114,56,94,319,187,150,333,230,104
1400000US36047079200,Census Tract 792,Brooklyn, New York,70,396,175,221,2357,877,1480,125,55,86,608,148,90,325,109,218
1400000US36047079400,Census Tract 794,Brooklyn, New York,70,272,104,168,1286,611,675,7,3,11,0,38,88,204,57,147
1400000US36047079602,Census Tract 796.02,Brooklyn, New York,70,454,126,328,3504,1427,2077,83,23,78,568,57,129,389,156,235
1400000US36047152200,Census Tract 1522,Brooklyn, New York,70,444,254,190,2431,1192,1239,107,61,70,180,176,84,185,39,146
1400000US36047021300,Census Tract 213,Brooklyn, New York,71,513,250,263,2978,1384,1594,28,14,20,101,0,89,253,143,110
1400000US36047031900,Census Tract 319,Brooklyn, New York,71,407,155,252,2075,769,1306,76,29,91,164,44,84,220,104,116
1400000US36047032100,Census Tract 321,Brooklyn, New York,71,797,463,334,3415,1425,1990,192,112,105,482,314,293,475,158,318
1400000US36047032300,Census Tract 323,Brooklyn, New York,71,371,173,198,2622,1199,1423,0,0,0,0,97,188,173,96,78
1400000US36047032500,Census Tract 325,Brooklyn, New York,71,1029,496,533,3976,1683,2293,128,62,98,274,173,250,680,296,385
1400000US36047032700,Census Tract 327,Brooklyn, New York,71,282,110,172,2317,896,1421,9,4,0,120,56,105,213,91,122
1400000US36047032900,Census Tract 329,Brooklyn, New York,71,535,172,363,3550,1522,2028,48,15,40,284,263,258,351,195,156
1400000US36047033100,Census Tract 331,Brooklyn, New York,71,506,301,205,2124,1040,1084,74,44,50,0,67,57,170,55,114
1400000US36047033300,Census Tract 333,Brooklyn, New York,71,819,464,355,2092,1056,1036,79,45,46,113,41,46,96,17,79
1400000US36047033500,Census Tract 335,Brooklyn, New York,71,335,201,134,1561,667,894,48,29,11,373,0,103,66,14,51
1400000US36047035500,Census Tract 355,Brooklyn, New York,71,538,197,341,2953,1205,1748,136,50,116,597,105,164,375,147,227
1400000US36047079601,Census Tract 796.01,Brooklyn, New York,71,339,234,105,3119,1119,2000,43,30,5,920,44,40,196,95,102
1400000US36047079801,Census Tract 798.01,Brooklyn, New York,71,517,180,337,2590,1219,1371,143,50,53,883,69,90,176,98,77
1400000US36047079802,Census Tract 798.02,Brooklyn, New York,71,545,358,187,3933,1715,2218,127,83,47,798,50,224,275,79,195
1400000US36047080000,Census Tract 800,Brooklyn, New York,71,435,237,198,2533,1078,1455,117,64,74,357,91,89,248,127,121
1400000US36047080200,Census Tract 802,Brooklyn, New York,71,332,235,97,2806,1078,1728,47,33,19,0,74,35,379,172,206
1400000US36047080400,Census Tract 804,Brooklyn, New York,71,418,151,267,2074,853,1221,127,46,69,684,75,53,212,105,107
1400000US36047080600,Census Tract 806,Brooklyn, New York,71,425,252,173,2092,828,1264,49,29,13,362,86,67,243,125,118
1400000US36047080800,Census Tract 808,Brooklyn, New York,71,57,49,8,1144,569,575,39,34,5,1144,146,195,244,124,120
1400000US36047081000,Census Tract 810,Brooklyn, New York,71,223,94,129,1395,695,700,18,8,4,162,61,14,133,74,58
1400000US36047087401,Census Tract 874.01,Brooklyn, New York,71,438,213,225,2824,1128,1696,45,22,47,0,131,226,330,133,197
1400000US36047087600,Census Tract 876,Brooklyn, New York,71,164,71,93,1177,534,643,92,40,80,392,115,10,77,12,64
1400000US36047087800,Census Tract 878,Brooklyn, New York,71,388,228,160,2319,941,1378,67,39,19,580,108,263,378,172,207
1400000US36047088000,Census Tract 880,Brooklyn, New York,71,257,67,190,2092,900,1192,0,0,0,0,60,111,157,58,98
1400000US36047000200,Census Tract 2,Brooklyn, New York,72,138,83,55,705,383,322,32,19,15,116,163,133,91,35,56
1400000US36047001800,Census Tract 18,Brooklyn, New York,72,284,284,0,2115,2003,112,157,157,0,0,154,0,527,499,28
1400000US36047002000,Census Tract 20,Brooklyn, New York,72,218,159,59,920,460,460,78,57,29,0,202,129,125,51,74
1400000US36047007200,Census Tract 72,Brooklyn, New York,72,312,193,119,1162,595,567,91,56,49,107,240,230,162,94,68
1400000US36047007400,Census Tract 74,Brooklyn, New York,72,701,314,387,3535,1840,1695,354,159,235,1488,776,670,781,375,407
1400000US36047007600,Census Tract 76,Brooklyn, New York,72,417,235,182,2698,1366,1332,171,96,71,1171,255,340,356,109,246
1400000US36047007800,Census Tract 78,Brooklyn, New York,72,574,292,282,3397,1735,1662,207,105,112,1097,526,540,713,409,302
1400000US36047008000,Census Tract 80,Brooklyn, New York,72,508,303,205,2640,1270,1370,169,101,62,993,362,507,259,151,107
1400000US36047008200,Census Tract 82,Brooklyn, New York,72,523,294,229,2709,1503,1206,254,143,139,889,337,328,469,210,259
1400000US36047008400,Census Tract 84,Brooklyn, New York,72,296,169,127,2181,1109,1072,57,33,43,0,176,343,327,243,85
1400000US36047008600,Census Tract 86,Brooklyn, New York,72,0,0,0,0,0,0,0,0,0,0,0,0,0,0,0
1400000US36047008800,Census Tract 88,Brooklyn, New York,72,408,169,239,2098,1045,1053,99,41,106,210,129,325,321,200,120
1400000US36047009000,Census Tract 90,Brooklyn, New York,72,392,173,219,1768,852,916,84,37,23,532,243,270,279,125,155
1400000US36047009200,Census Tract 92,Brooklyn, New York,72,463,240,223,2976,1451,1525,201,104,148,559,321,512,536,263,275
1400000US36047009600,Census Tract 96,Brooklyn, New York,72,559,347,212,3839,1792,2047,276,171,124,1321,599,622,507,271,237
1400000US36047009800,Census Tract 98,Brooklyn, New York,72,819,457,362,3985,1995,1990,365,204,190,1375,844,641,713,355,356
1400000US36047010000,Census Tract 100,Brooklyn, New York,72,814,444,370,4178,2110,2068,216,118,137,589,954,848,936,473,463
1400000US36047010100,Census Tract 101,Brooklyn, New York,72,390,223,167,2512,1226,1286,125,72,81,256,216,202,304,134,168
1400000US36047010200,Census Tract 102,Brooklyn, New York,72,512,273,239,3691,1893,1798,130,69,14,1761,753,690,716,327,388
1400000US36047010400,Census Tract 104,Brooklyn, New York,72,617,271,346,4105,2141,1964,141,62,94,796,822,742,731,392,340
1400000US36047010600,Census Tract 106,Brooklyn, New York,72,748,475,273,3923,1887,2036,333,211,115,1911,866,700,761,289,474
1400000US36047010800,Census Tract 108,Brooklyn, New York,72,472,269,203,3232,1675,1557,157,90,59,1257,511,567,491,271,220
1400000US36047011700,Census Tract 117,Brooklyn, New York,72,175,59,116,2188,1140,1048,16,5,0,302,154,151,112,68,43
1400000US36047014300,Census Tract 143,Brooklyn, New York,72,333,176,157,2496,1144,1352,0,0,0,0,196,97,182,45,137
1400000US36047014500,Census Tract 145,Brooklyn, New York,72,537,321,216,2761,1409,1352,71,42,12,676,275,206,174,101,72
1400000US36047014700,Census Tract 147,Brooklyn, New York,72,324,137,187,1388,755,633,35,15,48,0,41,17,79,22,57
1400000US36047016900,Census Tract 169,Brooklyn, New York,72,416,169,247,3436,1695,1741,41,17,42,168,178,113,206,44,160
1400000US36047017100,Census Tract 171,Brooklyn, New York,72,245,79,166,2945,1359,1586,0,0,0,0,48,71,50,34,14
1400000US36047017500,Census Tract 175,Brooklyn, New York,72,0,0,0,10,0,10,0,0,0,0,0,0,0,0,0
1400000US36047017700,Census Tract 177,Brooklyn, New York,72,0,0,0,0,0,0,0,0,0,0,0,0,0,0,0
1400000US36047050000,Census Tract 500,Brooklyn, New York,72,399,169,230,2554,1090,1464,13,6,18,0,33,60,69,25,42
1400000US36047050202,Census Tract 502.02,Brooklyn, New York,72,171,86,85,1804,701,1103,11,6,0,233,50,58,49,14,35
1400000US36047050400,Census Tract 504,Brooklyn, New York,72,617,386,231,3633,1688,1945,81,51,30,472,68,105,233,138,93
1400000US36047150200,Census Tract 1502,Brooklyn, New York,72,253,77,176,2012,946,1066,11,3,25,0,42,25,30,0,31
1400000US36047030300,Census Tract 303,Brooklyn, New York,73,474,259,215,2331,899,1432,207,113,132,520,46,90,692,303,390
1400000US36047036100,Census Tract 361,Brooklyn, New York,73,368,260,108,1185,504,681,82,58,23,296,14,91,283,167,116
1400000US36047036300,Census Tract 363,Brooklyn, New York,73,362,180,182,2370,1215,1155,47,23,31,209,283,96,322,136,187
1400000US36047036501,Census Tract 365.01,Brooklyn, New York,73,137,62,75,1657,748,909,0,0,0,0,80,108,133,72,60
1400000US36047036502,Census Tract 365.02,Brooklyn, New York,73,65,39,26,669,367,302,36,22,7,669,25,24,61,43,18
1400000US36047036700,Census Tract 367,Brooklyn, New York,73,90,44,46,812,408,404,24,12,0,424,35,18,49,6,43
1400000US36047036900,Census Tract 369,Brooklyn, New York,73,570,257,313,2578,1040,1538,147,66,126,363,86,78,492,196,297
1400000US36047037100,Census Tract 371,Brooklyn, New York,73,552,257,295,2773,1233,1540,87,41,67,272,69,111,347,174,172
1400000US36047037300,Census Tract 373,Brooklyn, New York,73,415,103,312,2242,858,1384,136,34,51,854,147,101,446,211,237
1400000US36047089000,Census Tract 890,Brooklyn, New York,73,512,112,400,4149,1977,2172,117,26,196,643,97,219,722,259,463
1400000US36047089200,Census Tract 892,Brooklyn, New York,73,334,181,153,2022,660,1362,81,44,52,265,54,120,271,103,168
1400000US36047089400,Census Tract 894,Brooklyn, New York,73,369,138,231,2051,950,1101,58,22,67,160,42,81,340,192,148
1400000US36047089600,Census Tract 896,Brooklyn, New York,73,243,142,101,1782,698,1084,8,5,6,0,61,63,173,54,119
1400000US36047089800,Census Tract 898,Brooklyn, New York,73,382,156,226,1010,398,612,57,23,82,0,19,0,96,44,52
1400000US36047090000,Census Tract 900,Brooklyn, New York,73,538,253,285,3151,1001,2150,116,55,47,819,55,243,529,197,333
1400000US36047090200,Census Tract 902,Brooklyn, New York,73,274,128,146,1988,857,1131,84,39,70,314,60,116,392,186,205
1400000US36047090600,Census Tract 906,Brooklyn, New York,73,438,194,244,2225,716,1509,181,80,118,794,46,161,587,186,401
1400000US36047090800,Census Tract 908,Brooklyn, New York,73,581,287,294,1757,384,1373,242,120,166,478,18,80,307,73,233
1400000US36047091000,Census Tract 910,Brooklyn, New York,73,707,436,271,3190,1039,2151,209,129,98,600,195,310,798,368,428
1400000US36047091200,Census Tract 912,Brooklyn, New York,73,859,373,486,3202,861,2341,349,151,180,1390,132,239,833,179,655
1400000US36047091600,Census Tract 916,Brooklyn, New York,73,526,227,299,2468,915,1553,159,69,71,866,81,84,585,200,387
1400000US36047091800,Census Tract 918,Brooklyn, New York,73,356,99,257,1566,512,1054,62,17,161,0,34,99,141,71,70
1400000US36047092200,Census Tract 922,Brooklyn, New York,73,210,0,210,1710,617,1093,60,0,0,489,27,118,190,80,110
1400000US36047092400,Census Tract 924,Brooklyn, New York,73,405,215,190,1628,605,1023,181,96,101,575,17,53,295,152,142
1400000US36047092800,Census Tract 928,Brooklyn, New York,73,178,96,82,1859,777,1082,38,20,15,454,4,48,160,71,89
1400000US36047113200,Census Tract 1132,Brooklyn, New York,73,221,93,128,1154,427,727,60,25,83,0,9,126,143,45,98
1400000US36047105801,Census Tract 1058.01,Brooklyn, New York,75,850,328,522,4521,1498,3023,35,13,0,303,96,320,488,219,269
1400000US36047105804,Census Tract 1058.04,Brooklyn, New York,75,534,100,434,4168,1151,3017,252,47,187,2009,96,151,392,121,269
1400000US36047107000,Census Tract 1070,Brooklyn, New York,75,10,5,5,453,238,215,5,3,0,453,127,63,12,11,1
1400000US36047107800,Census Tract 1078,Brooklyn, New York,75,364,119,245,2927,1109,1818,56,18,0,670,140,91,196,150,45
1400000US36047110400,Census Tract 1104,Brooklyn, New York,75,787,437,350,2770,1089,1681,208,115,59,1061,174,140,418,70,350
1400000US36047110600,Census Tract 1106,Brooklyn, New York,75,877,503,374,2410,577,1833,345,198,177,689,87,128,554,113,442
1400000US36047111000,Census Tract 1110,Brooklyn, New York,75,275,105,170,1979,493,1486,101,39,0,1176,131,138,518,121,398
1400000US36047111600,Census Tract 1116,Brooklyn, New York,75,250,151,99,1696,628,1068,32,19,21,0,64,42,149,40,109
1400000US36047111800,Census Tract 1118,Brooklyn, New York,75,256,108,148,1663,605,1058,99,42,78,472,103,167,133,69,63
1400000US36047112000,Census Tract 1120,Brooklyn, New York,75,339,167,172,2473,1136,1337,57,28,46,173,99,83,260,86,172
1400000US36047112200,Census Tract 1122,Brooklyn, New York,75,233,130,103,1736,671,1065,52,29,25,337,19,105,234,102,133
1400000US36047112400,Census Tract 1124,Brooklyn, New York,75,271,145,126,2009,708,1301,39,21,24,175,80,88,311,168,144
1400000US36047112600,Census Tract 1126,Brooklyn, New York,75,440,259,181,1905,805,1100,161,95,81,474,81,146,389,214,174
1400000US36047112800,Census Tract 1128,Brooklyn, New York,75,699,475,224,2381,956,1425,143,97,67,0,89,239,374,201,174
1400000US36047113000,Census Tract 1130,Brooklyn, New York,75,549,208,341,2533,996,1537,130,49,57,707,85,149,489,184,304
1400000US36047113400,Census Tract 1134,Brooklyn, New York,75,476,231,245,1419,483,936,179,87,128,336,17,167,360,176,185
1400000US36047114202,Census Tract 1142.02,Brooklyn, New York,75,360,108,252,1331,593,738,120,36,163,264,47,27,425,171,253
1400000US36047114400,Census Tract 1144,Brooklyn, New York,75,171,71,100,1179,440,739,66,27,69,200,66,36,215,36,179
1400000US36047114600,Census Tract 1146,Brooklyn, New York,75,153,60,93,1466,607,859,18,7,14,142,95,225,306,192,115
1400000US36047115000,Census Tract 1150,Brooklyn, New York,75,326,133,193,1127,534,593,136,55,83,461,171,111,136,83,53
1400000US36047115200,Census Tract 1152,Brooklyn, New York,75,397,180,217,1471,568,903,124,56,89,338,116,99,359,160,199
1400000US36047115600,Census Tract 1156,Brooklyn, New York,75,533,173,360,2168,744,1424,235,76,181,891,98,236,390,125,265
1400000US36047115800,Census Tract 1158,Brooklyn, New York,75,371,119,252,1404,578,826,85,27,0,473,66,21,338,90,248
1400000US36047116000,Census Tract 1160,Brooklyn, New York,75,257,186,71,1372,559,813,143,103,44,560,88,155,348,190,158
1400000US36047116200,Census Tract 1162,Brooklyn, New York,75,291,109,182,1271,557,714,41,15,37,132,47,43,98,25,73
1400000US36047116400,Census Tract 1164,Brooklyn, New York,75,320,176,144,1877,796,1081,66,36,2,822,66,58,98,18,80
1400000US36047116600,Census Tract 1166,Brooklyn, New York,75,504,253,251,1626,852,774,63,32,50,85,12,83,85,22,62
1400000US36047116800,Census Tract 1168,Brooklyn, New York,75,205,7,198,1476,739,737,70,2,57,506,32,12,111,40,71
1400000US36047117000,Census Tract 1170,Brooklyn, New York,75,118,85,33,1411,761,650,51,37,16,470,105,102,243,146,96
1400000US36047117201,Census Tract 1172.01,Brooklyn, New York,75,228,121,107,1352,664,688,76,40,9,834,194,138,226,104,122
1400000US36047117202,Census Tract 1172.02,Brooklyn, New York,75,421,231,190,2269,1002,1267,81,44,34,479,88,155,272,165,106
1400000US36047117400,Census Tract 1174,Brooklyn, New York,75,585,295,290,2687,1312,1375,213,107,124,806,144,166,406,178,228
1400000US36047117601,Census Tract 1176.01,Brooklyn, New York,75,338,141,197,1693,676,1017,178,74,127,748,73,132,283,171,111
1400000US36047117602,Census Tract 1176.02,Brooklyn, New York,75,504,282,222,2017,865,1152,103,58,48,381,61,132,288,133,156
1400000US36047117800,Census Tract 1178,Brooklyn, New York,75,112,34,78,908,469,439,32,10,0,372,74,35,148,76,72
1400000US36047118000,Census Tract 1180,Brooklyn, New York,75,0,0,0,0,0,0,0,0,0,0,0,0,0,0,0
1400000US36047118201,Census Tract 1182.01,Brooklyn, New York,75,617,372,245,1515,676,839,104,63,40,267,98,124,95,32,64
1400000US36047118202,Census Tract 1182.02,Brooklyn, New York,75,278,136,142,1787,799,988,105,51,63,566,66,113,291,156,135
1400000US36047118400,Census Tract 1184,Brooklyn, New York,75,728,335,393,3012,1465,1547,249,115,147,952,190,254,593,378,217
1400000US36047118600,Census Tract 1186,Brooklyn, New York,75,348,154,194,2126,1118,1008,52,23,30,306,77,172,215,140,75
1400000US36047118800,Census Tract 1188,Brooklyn, New York,75,576,269,307,2266,1035,1231,38,18,0,281,128,238,408,156,252
1400000US36047119000,Census Tract 1190,Brooklyn, New York,75,427,229,198,1121,456,665,78,42,34,221,67,80,179,49,130
1400000US36047119200,Census Tract 1192,Brooklyn, New York,75,394,156,238,1410,580,830,152,60,61,664,102,59,204,116,89
1400000US36047119400,Census Tract 1194,Brooklyn, New York,75,565,344,221,1994,910,1084,70,43,19,371,134,113,307,129,178
1400000US36047119600,Census Tract 1196,Brooklyn, New York,75,579,245,334,2644,1243,1401,107,45,33,658,91,66,381,189,191
1400000US36047119800,Census Tract 1198,Brooklyn, New York,75,413,218,195,1798,903,895,143,75,64,654,143,97,374,268,106
1400000US36047120000,Census Tract 1200,Brooklyn, New York,75,144,79,65,1567,920,647,38,21,24,216,96,35,279,224,55
1400000US36047120200,Census Tract 1202,Brooklyn, New York,75,229,112,117,995,488,507,28,14,29,0,54,53,94,32,62
1400000US36047120800,Census Tract 1208,Brooklyn, New York,75,671,338,333,5247,2084,3163,148,75,76,1118,192,297,404,200,202
1400000US36047121000,Census Tract 1210,Brooklyn, New York,75,654,346,308,2188,779,1409,101,53,50,319,52,127,565,155,410
1400000US36047121400,Census Tract 1214,Brooklyn, New York,75,544,286,258,1980,509,1471,188,99,87,699,119,207,408,156,252
1400000US36047122000,Census Tract 1220,Brooklyn, New York,75,535,275,260,2710,1030,1680,55,28,21,344,18,54,260,65,193
1400000US36081006202,Census Tract 62.02,Queens, New York,75,654,259,395,4592,1898,2694,158,63,62,1359,178,218,514,288,224
1400000US36047004500,Census Tract 45,Brooklyn, New York,76,89,40,49,2764,1266,1498,9,4,11,0,0,22,41,28,13
1400000US36047004700,Census Tract 47,Brooklyn, New York,76,40,18,22,862,389,473,13,6,0,509,9,11,12,0,12
1400000US36047004900,Census Tract 49,Brooklyn, New York,76,56,30,26,2061,868,1193,4,2,0,317,43,101,157,90,66
1400000US36047005100,Census Tract 51,Brooklyn, New York,76,76,26,50,1689,841,848,0,0,0,0,12,22,15,16,0
1400000US36047005300,Census Tract 53,Brooklyn, New York,76,167,130,37,1607,751,856,0,0,0,0,73,22,217,86,131
1400000US36047005900,Census Tract 59,Brooklyn, New York,76,102,27,75,939,448,491,1,0,3,0,65,79,6,0,6
1400000US36047006300,Census Tract 63,Brooklyn, New York,76,165,94,71,1549,703,846,11,6,8,0,11,72,60,35,25
1400000US36047006500,Census Tract 65,Brooklyn, New York,76,156,56,100,3980,1932,2048,47,17,0,1871,25,170,155,58,96
1400000US36047006700,Census Tract 67,Brooklyn, New York,76,182,68,114,2467,1087,1380,9,3,0,195,27,76,30,20,10
1400000US36047007500,Census Tract 75,Brooklyn, New York,76,231,82,149,3958,1964,1994,33,12,60,0,51,50,154,102,54
1400000US36047007700,Census Tract 77,Brooklyn, New York,76,268,82,186,3482,1747,1735,0,0,0,0,61,83,233,98,135
1400000US36047008500,Census Tract 85,Brooklyn, New York,76,1209,790,419,4090,1294,2796,380,248,139,1153,440,498,1027,311,719
1400000US36047020300,Census Tract 203,Brooklyn, New York,77,246,136,110,1218,572,646,0,0,0,0,40,42,67,43,24
1400000US36047020500,Census Tract 205,Brooklyn, New York,77,278,131,147,2171,1007,1164,13,6,15,0,9,68,137,56,81
1400000US36047021700,Census Tract 217,Brooklyn, New York,77,463,189,274,2388,976,1412,114,46,61,628,70,138,246,63,182
1400000US36047021900,Census Tract 219,Brooklyn, New York,77,505,287,218,2651,1186,1465,18,10,14,0,23,122,390,149,240
1400000US36047022100,Census Tract 221,Brooklyn, New York,77,485,270,215,2961,1571,1390,122,68,58,675,83,83,376,228,147
1400000US36047030500,Census Tract 305,Brooklyn, New York,77,691,298,393,4159,1758,2401,123,53,99,507,179,216,462,223,238
1400000US36047030900,Census Tract 309,Brooklyn, New York,77,248,109,139,983,460,523,65,29,20,347,16,26,278,107,171
1400000US36047031300,Census Tract 313,Brooklyn, New York,77,479,298,181,2899,1133,1766,46,29,21,191,52,79,304,127,178
1400000US36047031500,Census Tract 315,Brooklyn, New York,77,546,254,292,3653,1593,2060,202,94,153,862,178,68,373,244,128
1400000US36047031701,Census Tract 317.01,Brooklyn, New York,77,439,225,214,2367,831,1536,92,47,30,663,71,48,208,62,147
1400000US36047031702,Census Tract 317.02,Brooklyn, New York,77,499,260,239,2211,974,1237,22,11,20,0,52,49,252,146,106
1400000US36047033700,Census Tract 337,Brooklyn, New York,77,604,399,205,2218,1166,1052,41,27,7,304,79,56,224,119,104
1400000US36047033900,Census Tract 339,Brooklyn, New York,77,330,104,226,2906,1218,1688,88,28,41,886,79,142,314,189,127
1400000US36047034100,Census Tract 341,Brooklyn, New York,77,135,38,97,2045,961,1084,29,8,31,358,82,156,323,192,132
1400000US36047034300,Census Tract 343,Brooklyn, New York,77,670,387,283,2846,1030,1816,134,77,85,171,70,232,552,246,305
1400000US36047034500,Census Tract 345,Brooklyn, New York,77,90,13,77,1368,587,781,38,5,77,445,25,51,193,89,104
1400000US36047034700,Census Tract 347,Brooklyn, New York,77,393,182,211,1981,796,1185,91,42,66,319,11,115,307,98,209
1400000US36047034900,Census Tract 349,Brooklyn, New York,77,573,281,292,3790,1360,2430,168,82,80,1182,228,224,485,186,299
1400000US36047035100,Census Tract 351,Brooklyn, New York,77,485,216,269,2870,1088,1782,59,26,44,255,217,239,310,134,176
1400000US36047035300,Census Tract 353,Brooklyn, New York,77,524,220,304,2891,1237,1654,137,57,12,1217,99,205,370,110,260
1400000US36047035700,Census Tract 357,Brooklyn, New York,77,201,100,101,1205,340,865,38,19,16,263,35,97,201,48,153
1400000US36047035900,Census Tract 359,Brooklyn, New York,77,767,542,225,2857,959,1898,391,276,114,1474,157,104,723,141,581
1400000US36047003500,Census Tract 35,Brooklyn, New York,78,125,64,61,1164,547,617,7,4,7,0,28,10,203,131,71
1400000US36047007100,Census Tract 71,Brooklyn, New York,78,701,278,423,2869,1110,1759,161,64,102,637,153,245,473,216,257
1400000US36047011900,Census Tract 119,Brooklyn, New York,78,100,21,79,1262,569,693,29,6,19,384,56,2,121,42,79
1400000US36047012100,Census Tract 121,Brooklyn, New York,78,249,143,106,1478,744,734,0,0,0,0,39,11,160,81,78
1400000US36047012700,Census Tract 127,Brooklyn, New York,78,264,129,135,2347,1037,1310,57,28,45,244,135,159,439,167,272
1400000US36047012901,Census Tract 129.01,Brooklyn, New York,78,340,202,138,1814,796,1018,0,0,0,0,53,44,171,54,116
1400000US36047012902,Census Tract 129.02,Brooklyn, New York,78,243,95,148,1620,797,823,0,0,0,0,32,27,60,26,34
1400000US36047013100,Census Tract 131,Brooklyn, New York,78,241,99,142,3294,1458,1836,0,0,0,0,85,200,270,176,94
1400000US36047013300,Census Tract 133,Brooklyn, New York,78,223,177,46,2992,1344,1648,2,2,0,129,32,86,194,46,147
1400000US36047013500,Census Tract 135,Brooklyn, New York,78,258,77,181,2573,1120,1453,0,0,0,0,0,65,75,37,36
1400000US36047013700,Census Tract 137,Brooklyn, New York,78,121,63,58,2440,1233,1207,0,0,0,0,28,41,142,73,68
1400000US36047013900,Census Tract 139,Brooklyn, New York,78,398,144,254,2667,1319,1348,85,31,85,389,58,92,176,129,46
1400000US36047014100,Census Tract 141,Brooklyn, New York,78,359,175,184,2066,1080,986,21,10,12,112,52,25,68,59,9
1400000US36047014900,Census Tract 149,Brooklyn, New York,78,345,29,316,3925,1811,2114,9,1,87,12,53,76,212,92,118
1400000US36047015100,Census Tract 151,Brooklyn, New York,78,204,46,158,2952,1488,1464,9,2,27,18,9,97,171,71,100
1400000US36047015300,Census Tract 153,Brooklyn, New York,78,163,92,71,2218,905,1313,0,0,0,0,12,24,22,10,13
1400000US36047015500,Census Tract 155,Brooklyn, New York,78,345,232,113,2518,1291,1227,0,0,0,0,36,21,65,28,38
1400000US36047015700,Census Tract 157,Brooklyn, New York,78,139,37,102,3169,1296,1873,36,10,25,840,36,81,54,19,36
1400000US36047015900,Census Tract 159,Brooklyn, New York,78,321,219,102,4749,2376,2373,0,0,0,0,19,14,199,138,62
1400000US36047016100,Census Tract 161,Brooklyn, New York,78,208,45,163,2581,1193,1388,0,0,0,0,66,62,93,26,67
1400000US36047016300,Census Tract 163,Brooklyn, New York,78,263,152,111,2396,1161,1235,40,23,3,776,55,31,168,98,70
1400000US36047016500,Census Tract 165,Brooklyn, New York,78,183,40,143,3900,1841,2059,18,4,54,82,63,0,43,33,10
1400000US36047016700,Census Tract 167,Brooklyn, New York,78,665,227,438,3586,1937,1649,77,26,0,631,85,26,93,41,54
1400000US36047020700,Census Tract 207,Brooklyn, New York,78,163,102,61,3983,1758,2225,41,26,25,0,46,38,147,44,102
1400000US36047021500,Census Tract 215,Brooklyn, New York,78,364,82,282,3902,1608,2294,0,0,0,0,3,94,113,68,46
1400000US36047019300,Census Tract 193,Brooklyn, New York,79,1966,897,1069,3282,1429,1853,73,33,13,187,104,54,263,100,161
1400000US36047022900,Census Tract 229,Brooklyn, New York,79,339,170,169,2245,812,1433,40,20,36,54,40,67,211,126,86
1400000US36047023300,Census Tract 233,Brooklyn, New York,79,671,333,338,2943,1217,1726,93,46,34,515,77,185,224,82,142
1400000US36047023500,Census Tract 235,Brooklyn, New York,79,492,201,291,1743,820,923,8,3,0,47,79,74,73,0,73
1400000US36047024100,Census Tract 241,Brooklyn, New York,79,387,156,231,1261,727,534,87,35,117,44,41,98,108,80,28
1400000US36047024300,Census Tract 243,Brooklyn, New York,79,415,189,226,2861,1160,1701,86,39,91,126,48,56,463,216,247
1400000US36047024500,Census Tract 245,Brooklyn, New York,79,379,313,66,2747,1326,1421,0,0,0,0,131,119,217,135,82
1400000US36047024700,Census Tract 247,Brooklyn, New York,79,231,133,98,1390,658,732,26,15,15,85,0,12,56,12,44
1400000US36047024900,Census Tract 249,Brooklyn, New York,79,413,313,100,2622,1262,1360,104,79,24,734,32,101,231,116,114
1400000US36047025100,Census Tract 251,Brooklyn, New York,79,585,253,332,2110,1019,1091,201,87,138,610,169,60,363,126,237
1400000US36047025300,Census Tract 253,Brooklyn, New York,79,225,61,164,1330,621,709,83,23,32,576,36,64,113,55,58
1400000US36047025500,Census Tract 255,Brooklyn, New York,79,784,426,358,2597,685,1912,316,172,103,1400,128,419,691,161,530
1400000US36047025700,Census Tract 257,Brooklyn, New York,79,347,111,236,907,386,521,61,20,102,50,41,102,93,54,39
1400000US36047025901,Census Tract 259.01,Brooklyn, New York,79,218,65,153,1058,400,658,46,14,0,318,67,96,99,47,52
1400000US36047025902,Census Tract 259.02,Brooklyn, New York,79,501,236,265,1750,628,1122,276,130,173,805,184,229,322,113,209
1400000US36047026100,Census Tract 261,Brooklyn, New York,79,602,217,385,2731,1197,1534,61,22,35,289,186,166,224,114,110
1400000US36047026300,Census Tract 263,Brooklyn, New York,79,135,64,71,1297,508,789,53,25,47,201,63,73,134,69,65
1400000US36047026500,Census Tract 265,Brooklyn, New York,79,454,205,249,2475,903,1572,91,41,79,257,93,50,418,131,288
1400000US36047026700,Census Tract 267,Brooklyn, New York,79,393,234,159,2738,1245,1493,36,22,24,0,103,109,194,110,87
1400000US36047026900,Census Tract 269,Brooklyn, New York,79,218,84,134,1633,620,1013,87,34,43,732,34,47,247,113,133
1400000US36047027100,Census Tract 271,Brooklyn, New York,79,250,184,66,1822,926,896,59,43,17,332,73,109,264,176,88
1400000US36047027300,Census Tract 273,Brooklyn, New York,79,484,279,205,1871,859,1012,188,108,122,200,78,105,268,156,112
1400000US36047027500,Census Tract 275,Brooklyn, New York,79,285,134,151,2775,1440,1335,52,24,12,755,117,96,339,202,136
1400000US36047027700,Census Tract 277,Brooklyn, New York,79,278,161,117,2567,1106,1461,35,20,8,526,36,148,488,309,180
1400000US36047027900,Census Tract 279,Brooklyn, New York,79,278,112,166,2184,849,1335,66,27,0,869,106,117,271,49,222
1400000US36047028100,Census Tract 281,Brooklyn, New York,79,442,247,195,2625,1168,1457,91,51,60,202,106,117,606,181,425
1400000US36047028502,Census Tract 285.02,Brooklyn, New York,79,267,105,162,1686,522,1164,83,33,74,364,150,277,448,139,308
1400000US36047031100,Census Tract 311,Brooklyn, New York,79,143,93,50,1837,754,1083,96,62,33,1286,59,62,211,112,99
1400000US36047123700,Census Tract 1237,Brooklyn, New York,79,488,271,217,2296,1407,889,174,97,94,604,279,56,324,194,130
1400000US36047028300,Census Tract 283,Brooklyn, New York,81,403,169,234,1871,812,1059,143,60,33,952,246,102,380,163,217
1400000US36047028501,Census Tract 285.01,Brooklyn, New York,81,81,48,33,457,299,158,44,26,30,0,35,41,69,66,3
1400000US36047028700,Census Tract 287,Brooklyn, New York,81,288,137,151,1881,868,1013,73,35,24,636,202,146,273,141,132
1400000US36047028900,Census Tract 289,Brooklyn, New York,81,474,246,228,2246,1073,1173,128,66,93,276,222,148,366,134,233
1400000US36047029100,Census Tract 291,Brooklyn, New York,81,375,266,109,1747,753,994,118,84,24,961,86,80,231,92,138
1400000US36047029300,Census Tract 293,Brooklyn, New York,81,284,144,140,1951,738,1213,95,48,92,0,79,125,326,119,207
1400000US36047029500,Census Tract 295,Brooklyn, New York,81,214,28,186,2666,1089,1577,17,2,0,243,50,76,344,220,125
1400000US36047029700,Census Tract 297,Brooklyn, New York,81,206,22,184,2492,1067,1425,28,3,0,379,27,38,331,147,185
1400000US36047029900,Census Tract 299,Brooklyn, New York,81,180,78,102,1330,418,912,45,20,37,222,34,126,271,88,183
1400000US36047030100,Census Tract 301,Brooklyn, New York,81,253,54,199,1782,808,974,133,28,77,1003,187,212,271,70,200
1400000US36047030700,Census Tract 307,Brooklyn, New York,81,419,242,177,2551,978,1573,180,104,85,908,141,175,602,258,343
1400000US36047037500,Census Tract 375,Brooklyn, New York,81,282,185,97,1720,729,991,132,87,51,621,126,91,256,126,131
1400000US36047037700,Census Tract 377,Brooklyn, New York,81,504,261,243,2640,987,1653,122,63,35,924,84,122,140,48,93
1400000US36047037900,Census Tract 379,Brooklyn, New York,81,578,204,374,2377,909,1468,221,78,185,763,17,75,240,58,184
1400000US36047038100,Census Tract 381,Brooklyn, New York,81,619,387,232,2895,1159,1736,182,114,87,449,83,212,524,226,297
1400000US36047038300,Census Tract 383,Brooklyn, New York,81,346,105,241,2697,1317,1380,76,23,96,380,83,51,321,186,134
1400000US36047038500,Census Tract 385,Brooklyn, New York,81,397,203,194,2182,947,1235,103,53,98,0,146,112,391,219,170
1400000US36047038700,Census Tract 387,Brooklyn, New York,81,370,243,127,2266,914,1352,113,74,49,340,96,224,435,217,219
1400000US36047038900,Census Tract 389,Brooklyn, New York,83,348,190,158,1662,871,791,109,59,73,221,71,250,198,82,116
1400000US36047039100,Census Tract 391,Brooklyn, New York,83,268,125,143,1792,957,835,45,21,34,188,293,301,168,127,41
1400000US36047039300,Census Tract 393,Brooklyn, New York,83,524,249,275,2303,1066,1237,55,26,24,276,152,209,196,39,157
1400000US36047039500,Census Tract 395,Brooklyn, New York,83,350,149,201,2248,1049,1199,79,34,92,124,257,311,299,98,201
1400000US36047039700,Census Tract 397,Brooklyn, New York,83,310,121,189,2129,884,1245,59,23,55,270,84,235,264,129,134
1400000US36047039900,Census Tract 399,Brooklyn, New York,83,474,194,280,2436,1060,1376,16,7,23,0,202,215,475,231,245
1400000US36047040100,Census Tract 401,Brooklyn, New York,83,674,287,387,1817,812,1005,271,115,173,672,23,82,240,165,74
1400000US36047040300,Census Tract 403,Brooklyn, New York,83,412,225,187,1979,773,1206,119,65,93,73,136,117,291,107,185
1400000US36047040500,Census Tract 405,Brooklyn, New York,83,399,264,135,830,361,469,199,132,82,240,48,19,88,39,49
1400000US36047040700,Census Tract 407,Brooklyn, New York,83,0,0,0,0,0,0,0,0,0,0,0,0,0,0,0
1400000US36047040900,Census Tract 409,Brooklyn, New York,83,445,258,187,2064,991,1073,166,96,95,386,307,295,452,196,258
1400000US36047041100,Census Tract 411,Brooklyn, New York,83,312,180,132,1872,839,1033,105,61,62,298,155,100,350,135,215
1400000US36047041300,Census Tract 413,Brooklyn, New York,83,397,132,265,2122,881,1241,188,63,78,1193,202,294,403,252,151
1400000US36047041500,Census Tract 415,Brooklyn, New York,83,309,120,189,2380,865,1515,44,17,16,428,128,195,533,180,351
1400000US36047041700,Census Tract 417,Brooklyn, New York,83,362,179,183,2170,816,1354,112,55,115,0,111,130,417,132,284
1400000US36047041900,Census Tract 419,Brooklyn, New York,83,357,218,139,2148,931,1217,105,64,38,696,107,208,346,149,197
1400000US36047042100,Census Tract 421,Brooklyn, New York,83,592,239,353,2178,1074,1104,162,65,86,643,211,254,301,124,177
1400000US36047042300,Census Tract 423,Brooklyn, New York,83,678,381,297,2161,1176,985,329,185,157,925,467,329,328,174,154
1400000US36047042500,Census Tract 425,Brooklyn, New York,83,466,219,247,1449,760,689,102,48,63,270,212,102,171,74,97
1400000US36047042700,Census Tract 427,Brooklyn, New York,83,1051,443,608,3237,1737,1500,446,188,375,923,695,461,382,198,185
1400000US36047042900,Census Tract 429,Brooklyn, New York,83,795,422,373,3803,1993,1810,278,148,170,878,929,731,635,301,337
1400000US36047043100,Census Tract 431,Brooklyn, New York,83,817,494,323,3212,1597,1615,377,228,152,1433,623,707,501,241,262
1400000US36047043300,Census Tract 433,Brooklyn, New York,83,480,317,163,2524,1153,1371,192,127,43,1673,371,463,631,280,352
1400000US36047043500,Census Tract 435,Brooklyn, New York,83,975,668,307,2900,1369,1531,312,214,108,728,571,458,421,203,217
1400000US36047043700,Census Tract 437,Brooklyn, New York,83,875,442,433,2747,1239,1508,156,79,49,673,212,155,500,192,308
1400000US36047043900,Census Tract 439,Brooklyn, New York,83,590,254,336,2307,1167,1140,176,76,114,618,298,241,457,229,228
1400000US36047044100,Census Tract 441,Brooklyn, New York,83,829,500,329,3704,2006,1698,369,223,202,696,754,662,604,379,226
1400000US36047044300,Census Tract 443,Brooklyn, New York,83,846,498,348,3570,1816,1754,272,160,128,903,779,516,564,278,288
1400000US36047044500,Census Tract 445,Brooklyn, New York,83,875,506,369,2851,1497,1354,291,168,145,710,356,385,382,237,145
1400000US36047044700,Census Tract 447,Brooklyn, New York,83,195,73,122,1480,755,725,31,12,33,133,136,84,169,30,138
1400000US36047000100,Census Tract 1,Brooklyn, New York,84,347,254,93,3875,1718,2157,0,0,0,0,0,28,50,29,19
1400000US36047000301,Census Tract 3.01,Brooklyn, New York,84,194,111,83,3782,1836,1946,0,0,0,0,0,2,0,2,0
1400000US36047000501,Census Tract 5.01,Brooklyn, New York,84,380,288,92,2703,1321,1382,0,0,0,0,38,51,38,17,19
1400000US36047000502,Census Tract 5.02,Brooklyn, New York,84,171,63,108,2130,1072,1058,3,1,0,60,0,0,2,0,3
1400000US36047000700,Census Tract 7,Brooklyn, New York,84,143,57,86,2850,1449,1401,3,1,5,0,1,0,17,7,11
1400000US36047000900,Census Tract 9,Brooklyn, New York,84,686,406,280,3253,1632,1621,0,0,0,0,38,49,20,18,0
1400000US36047001100,Census Tract 11,Brooklyn, New York,84,127,79,48,181,76,105,0,0,0,0,18,0,0,0,0
1400000US36047001300,Census Tract 13,Brooklyn, New York,84,245,177,68,2054,1089,965,0,0,0,0,0,14,21,11,9
1400000US36047002100,Census Tract 21,Brooklyn, New York,84,62,45,17,2489,1354,1135,21,15,6,879,9,32,55,53,3
1400000US36047002300,Census Tract 23,Brooklyn, New York,84,616,370,246,2151,603,1548,145,87,29,884,83,339,290,32,259
1400000US36047003300,Census Tract 33,Brooklyn, New York,84,102,47,55,2059,979,1080,25,12,28,37,17,36,76,27,50
1400000US36047003700,Census Tract 37,Brooklyn, New York,84,36,13,23,220,150,70,0,0,0,0,0,0,21,9,12
1400000US36047003900,Census Tract 39,Brooklyn, New York,84,82,8,74,1975,959,1016,12,1,0,320,67,64,144,90,55
1400000US36047004100,Census Tract 41,Brooklyn, New York,84,123,21,102,2832,1423,1409,11,2,53,0,110,65,198,71,125
1400000US36047004300,Census Tract 43,Brooklyn, New York,84,359,144,215,2387,1359,1028,24,10,36,0,159,91,105,105,0
1400000US36061000500,Census Tract 5,Manhattan, New York,84,0,0,0,0,0,0,0,0,0,0,0,0,0,0,0
1400000US36061000700,Census Tract 7,Manhattan, New York,84,1176,524,652,4819,2515,2304,5,2,7,0,0,76,0,0,0
1400000US36061000900,Census Tract 9,Manhattan, New York,84,48,26,22,495,285,210,7,4,6,0,0,0,33,16,17
1400000US36061001502,Census Tract 15.02,Manhattan, New York,84,2545,1013,1532,3821,1814,2007,28,11,20,34,2,0,4,2,2
1400000US36047006900,Census Tract 69,Brooklyn, New York,85,266,133,133,2721,1271,1450,26,13,26,0,48,75,16,15,0
1400000US36047001500,Census Tract 15,Brooklyn, New York,88,214,162,52,2346,1190,1156,49,37,15,136,98,71,298,169,129
1400000US36047002901,Census Tract 29.01,Brooklyn, New York,88,335,174,161,1666,491,1175,147,76,51,951,70,88,408,121,288
1400000US36047003100,Census Tract 31,Brooklyn, New York,88,804,213,591,1664,746,918,11,3,31,0,62,144,196,78,119
1400000US36047017900,Census Tract 179,Brooklyn, New York,88,352,101,251,2836,1210,1626,53,15,65,306,134,124,386,184,203
1400000US36047018100,Census Tract 181,Brooklyn, New York,88,157,91,66,3459,1468,1991,55,32,30,681,57,28,121,53,70
1400000US36047018300,Census Tract 183,Brooklyn, New York,88,157,34,123,1850,858,992,15,3,54,0,9,0,9,9,0
1400000US36047018501,Census Tract 185.01,Brooklyn, New York,88,427,177,250,1969,647,1322,145,60,89,646,72,219,567,129,438
1400000US36047018700,Census Tract 187,Brooklyn, New York,88,202,160,42,1062,532,530,17,13,4,0,5,64,30,7,23
1400000US36047019100,Census Tract 191,Brooklyn, New York,88,383,200,183,1527,704,823,65,34,29,275,46,86,185,115,70
1400000US36047019500,Census Tract 195,Brooklyn, New York,88,319,106,213,3210,1669,1541,13,4,26,0,92,40,202,53,149
1400000US36047019700,Census Tract 197,Brooklyn, New York,88,183,91,92,2663,1325,1338,0,0,0,0,60,24,107,62,44
1400000US36047019900,Census Tract 199,Brooklyn, New York,88,336,131,205,2272,991,1281,9,4,14,0,27,6,84,38,47
1400000US36047020100,Census Tract 201,Brooklyn, New York,88,234,89,145,2634,1199,1435,0,0,0,0,7,30,45,0,44
1400000US36047021100,Census Tract 211,Brooklyn, New York,88,169,132,37,868,576,292,36,28,10,0,144,37,126,90,36
1400000US36047022700,Census Tract 227,Brooklyn, New York,88,511,251,260,1936,904,1032,47,23,49,0,26,122,230,115,115
1400000US36047023100,Census Tract 231,Brooklyn, New York,88,731,395,336,2288,863,1425,104,56,47,334,47,66,227,111,115
1400000US36047054300,Census Tract 543,Brooklyn, New York,88,31,16,15,157,79,78,0,0,0,0,0,0,16,0,16
1400000US36047045300,Census Tract 453,Brooklyn, New York,90,284,169,115,1288,542,746,85,51,38,325,92,178,161,60,101
1400000US36047047700,Census Tract 477,Brooklyn, New York,90,363,113,250,2481,1287,1194,51,16,44,308,39,104,104,28,75
1400000US36047048100,Census Tract 481,Brooklyn, New York,90,517,184,333,1966,1004,962,14,5,0,83,92,161,218,151,68
1400000US36047048500,Census Tract 485,Brooklyn, New York,90,432,217,215,1844,1113,731,48,24,26,188,55,133,138,110,29
1400000US36047048900,Census Tract 489,Brooklyn, New York,90,660,287,373,2327,648,1679,255,111,201,624,242,515,496,161,336
1400000US36047049100,Census Tract 491,Brooklyn, New York,90,646,348,298,4109,1884,2225,123,66,21,1364,398,534,612,273,338
1400000US36047049300,Census Tract 493,Brooklyn, New York,90,979,320,659,4861,2203,2658,267,87,214,1201,529,872,608,337,268
1400000US36047049500,Census Tract 495,Brooklyn, New York,90,306,103,203,2037,970,1067,49,16,97,0,29,30,354,205,149
1400000US36047049700,Census Tract 497,Brooklyn, New York,90,254,96,158,2258,1071,1187,39,15,20,386,62,146,210,61,148
1400000US36047050300,Census Tract 503,Brooklyn, New York,90,287,41,246,2104,1016,1088,0,0,0,0,140,59,238,132,106
1400000US36047050500,Census Tract 505,Brooklyn, New York,90,492,296,196,2900,1182,1718,44,26,29,0,174,376,406,176,228
1400000US36047050700,Census Tract 507,Brooklyn, New York,90,173,88,85,645,319,326,13,7,13,0,72,51,147,68,79
1400000US36047050900,Census Tract 509,Brooklyn, New York,90,355,206,149,1185,621,564,134,78,80,182,147,82,224,84,140
1400000US36047051100,Census Tract 511,Brooklyn, New York,90,458,114,344,2600,1095,1505,147,37,109,840,177,427,239,135,105
1400000US36047051300,Census Tract 513,Brooklyn, New York,90,647,340,307,2940,1438,1502,81,43,41,344,102,138,338,193,146
1400000US36047051900,Census Tract 519,Brooklyn, New York,90,218,125,93,3064,1384,1680,38,22,17,493,152,82,104,32,72
1400000US36047052300,Census Tract 523,Brooklyn, New York,90,1011,595,416,3860,1549,2311,268,158,134,706,319,476,691,246,446
1400000US36047052500,Census Tract 525,Brooklyn, New York,90,452,244,208,1659,695,964,132,71,78,319,140,212,416,133,284
1400000US36047052700,Census Tract 527,Brooklyn, New York,90,805,319,486,4345,2036,2309,228,90,221,743,558,640,717,354,365
1400000US36047052900,Census Tract 529,Brooklyn, New York,90,615,264,351,1592,757,835,177,76,113,417,49,117,363,192,171
1400000US36047053100,Census Tract 531,Brooklyn, New York,90,829,384,445,2247,1123,1124,110,51,69,252,179,51,290,65,224
1400000US36047053300,Census Tract 533,Brooklyn, New York,90,1042,577,465,2651,1386,1265,311,172,97,1090,238,108,506,223,285
1400000US36047053500,Census Tract 535,Brooklyn, New York,90,680,412,268,1642,719,923,176,107,61,509,132,125,401,158,243
1400000US36047053700,Census Tract 537,Brooklyn, New York,90,320,152,168,1334,650,684,74,35,50,231,88,76,296,151,145
1400000US36047053900,Census Tract 539,Brooklyn, New York,90,443,280,163,1520,701,819,162,102,54,652,166,103,245,47,197
1400000US36047054500,Census Tract 545,Brooklyn, New York,90,941,467,474,3664,1640,2024,220,109,119,795,289,374,927,385,542
1400000US36047054700,Census Tract 547,Brooklyn, New York,90,605,333,272,2223,1064,1159,121,67,57,418,120,83,418,145,274
1400000US36047054900,Census Tract 549,Brooklyn, New York,90,171,42,129,1787,959,828,51,13,0,706,34,34,66,28,39
1400000US36047055100,Census Tract 551,Brooklyn, New York,90,455,260,195,3637,2017,1620,32,18,9,375,180,230,306,220,86
1400000US36047055300,Census Tract 553,Brooklyn, New York,90,291,170,121,1910,900,1010,15,9,11,0,0,56,160,68,92
1400000US36047055500,Census Tract 555,Brooklyn, New York,90,268,159,109,1606,615,991,41,24,28,0,0,15,39,0,38
1400000US36047044900,Census Tract 449,Brooklyn, New York,94,457,236,221,2004,805,1199,130,67,17,1016,111,181,409,162,246
1400000US36047049900,Census Tract 499,Brooklyn, New York,94,314,114,200,1114,557,557,31,11,54,0,12,6,81,24,57
1400000US36047050100,Census Tract 501,Brooklyn, New York,94,227,72,155,2089,924,1165,21,7,0,282,96,98,213,106,108
1400000US36047051500,Census Tract 515,Brooklyn, New York,94,107,13,94,1057,521,536,0,0,0,0,52,28,97,57,40
1400000US36047051700,Census Tract 517,Brooklyn, New York,94,90,25,65,1417,753,664,12,3,0,262,14,11,45,16,29
1400000US36047055700,Census Tract 557,Brooklyn, New York,94,271,128,143,1076,552,524,57,27,0,429,21,0,22,22,0
1400000US36047056100,Census Tract 561,Brooklyn, New York,94,157,107,50,2700,1386,1314,0,0,0,0,19,108,132,43,88
1400000US36047056300,Census Tract 563,Brooklyn, New York,94,232,112,120,3539,1789,1750,35,17,32,149,195,257,326,233,95
1400000US36047056500,Census Tract 565,Brooklyn, New York,94,217,105,112,2474,1137,1337,0,0,0,0,20,182,47,17,31
1400000US36047056900,Census Tract 569,Brooklyn, New York,94,230,13,217,1080,609,471,3,0,0,15,0,0,122,60,62
1400000US36047057100,Census Tract 571,Brooklyn, New York,94,497,226,271,3547,1815,1732,63,29,43,355,15,102,50,24,26
1400000US36047057300,Census Tract 573,Brooklyn, New York,94,87,23,64,1811,873,938,0,0,0,0,54,85,103,75,29
1400000US36047057500,Census Tract 575,Brooklyn, New York,94,373,160,213,2671,1341,1330,20,9,11,150,34,61,126,54,72
1400000US36047057900,Census Tract 579,Brooklyn, New York,94,184,83,101,751,434,317,75,34,12,484,51,22,38,8,30
1400000US36047058900,Census Tract 589,Brooklyn, New York,94,132,50,82,1302,616,686,0,0,0,0,22,30,68,34,34
1400000US36047059100,Census Tract 591,Brooklyn, New York,94,274,129,145,2900,1514,1386,0,0,0,0,45,62,131,79,51
1400000US36047059300,Census Tract 593,Brooklyn, New York,94,212,76,136,1153,644,509,0,0,0,0,31,39,46,5,41
1400000US36047070203,Census Tract 702.03,Brooklyn, New York,100,0,0,0,0,0,0,0,0,0,0,0,0,0,0,0
1400000US36081091601,Census Tract 916.01,Queens, New York,100,290,158,132,3181,1495,1686,26,14,22,0,12,12,162,84,79
1400000US36081091602,Census Tract 916.02,Queens, New York,100,0,0,0,0,0,0,0,0,0,0,0,0,0,0,0
1400000US36081091800,Census Tract 918,Queens, New York,100,0,0,0,9,0,9,0,0,0,0,0,0,0,0,0
1400000US36081092200,Census Tract 922,Queens, New York,100,88,80,8,1609,781,828,0,0,0,0,3,13,56,56,0
1400000US36081092800,Census Tract 928,Queens, New York,100,291,193,98,2374,1110,1264,16,11,8,0,0,21,102,42,59
1400000US36081093401,Census Tract 934.01,Queens, New York,100,206,73,133,3136,1422,1714,13,5,24,0,30,22,125,34,91
1400000US36081093402,Census Tract 934.02,Queens, New York,100,257,179,78,3112,1552,1560,0,0,0,0,116,75,180,112,70
1400000US36081093800,Census Tract 938,Queens, New York,100,322,180,142,3744,1661,2083,141,79,85,869,105,260,329,228,102
1400000US36081094201,Census Tract 942.01,Queens, New York,100,336,81,255,2295,1023,1272,94,23,66,656,8,69,413,212,200
1400000US36081094202,Census Tract 942.02,Queens, New York,100,458,221,237,2582,1086,1496,148,71,92,676,43,37,452,159,292
1400000US36081094203,Census Tract 942.03,Queens, New York,100,281,94,187,3797,1750,2047,15,5,30,0,61,88,456,156,301
1400000US36081095400,Census Tract 954,Queens, New York,100,416,268,148,3054,1421,1633,42,27,23,21,99,118,425,209,214
1400000US36081096400,Census Tract 964,Queens, New York,100,412,172,240,2620,1214,1406,71,30,45,427,110,86,406,210,195
1400000US36081107201,Census Tract 1072.01,Queens, New York,100,155,56,99,1711,864,847,2,1,4,0,21,17,188,137,52
1400000US36081097202,Census Tract 972.02,Queens, New York,101,291,131,160,1089,400,689,71,32,46,224,16,10,235,74,161
1400000US36081097203,Census Tract 972.03,Queens, New York,101,1000,409,591,3738,1466,2272,334,137,308,766,141,320,863,292,573
1400000US36081097204,Census Tract 972.04,Queens, New York,101,269,140,129,2516,1058,1458,115,60,76,624,165,182,292,133,157
1400000US36081099200,Census Tract 992,Queens, New York,101,490,228,262,1994,780,1214,99,46,53,403,55,90,417,156,261
1400000US36081099801,Census Tract 998.01,Queens, New York,101,822,520,302,4414,1840,2574,108,68,62,31,342,314,481,232,250
1400000US36081099802,Census Tract 998.02,Queens, New York,101,154,68,86,3465,1333,2132,27,12,19,485,183,235,371,144,226
1400000US36081100801,Census Tract 1008.01,Queens, New York,101,390,204,186,1349,669,680,105,55,69,210,28,26,81,33,48
1400000US36081100802,Census Tract 1008.02,Queens, New York,101,1114,421,693,4121,1647,2474,238,90,143,898,91,203,396,180,215
1400000US36081101001,Census Tract 1010.01,Queens, New York,101,1360,824,536,6197,2635,3562,560,339,231,2367,406,484,905,485,420
1400000US36081101002,Census Tract 1010.02,Queens, New York,101,354,201,153,2617,1196,1421,31,18,18,120,150,82,317,118,199
1400000US36081103201,Census Tract 1032.01,Queens, New York,101,695,295,400,3664,1703,1961,186,79,107,982,298,306,876,359,514
1400000US36081103202,Census Tract 1032.02,Queens, New York,101,651,306,345,3458,1700,1758,109,51,69,481,221,137,367,218,148
1400000US36081000200,Census Tract 2,Queens, New York,102,385,232,153,2106,981,1125,83,50,43,234,106,167,238,150,89
1400000US36081000400,Census Tract 4,Queens, New York,102,661,342,319,2980,1400,1580,165,86,80,739,148,221,274,182,92
1400000US36081000600,Census Tract 6,Queens, New York,102,438,194,244,2015,878,1137,120,53,89,405,162,201,270,175,96
1400000US36081000800,Census Tract 8,Queens, New York,102,311,242,69,2297,1188,1109,58,45,15,133,67,147,306,154,150
1400000US36081001000,Census Tract 10,Queens, New York,102,481,330,151,2071,928,1143,72,50,33,0,125,95,255,147,107
1400000US36081001200,Census Tract 12,Queens, New York,102,354,138,216,2775,1342,1433,33,13,14,308,106,163,369,203,166
1400000US36081001400,Census Tract 14,Queens, New York,102,437,213,224,2514,1331,1183,119,58,97,304,126,138,390,218,172
1400000US36081001600,Census Tract 16,Queens, New York,102,324,185,139,1865,812,1053,78,45,42,295,163,162,265,191,73
1400000US36081001800,Census Tract 18,Queens, New York,102,362,195,167,1873,914,959,121,65,73,405,105,86,101,44,57
1400000US36081002000,Census Tract 20,Queens, New York,102,154,71,83,1024,524,500,55,25,14,530,8,41,110,42,68
1400000US36081002200,Census Tract 22,Queens, New York,102,151,63,88,1296,640,656,0,0,0,0,65,67,82,12,70
1400000US36081002400,Census Tract 24,Queens, New York,102,353,251,102,1444,729,715,36,26,11,142,91,116,121,43,79
1400000US36081002600,Census Tract 26,Queens, New York,102,187,114,73,1315,717,598,30,18,19,0,1,42,92,88,4
1400000US36081002800,Census Tract 28,Queens, New York,102,454,293,161,2039,918,1121,54,35,24,126,141,240,202,95,106
1400000US36081003000,Census Tract 30,Queens, New York,102,84,57,27,1126,539,587,0,0,0,0,9,85,184,113,71
1400000US36081003200,Census Tract 32,Queens, New York,102,130,97,33,830,410,420,22,16,3,352,16,24,184,82,102
1400000US36081003400,Census Tract 34,Queens, New York,102,246,90,156,1482,670,812,47,17,14,371,43,110,138,70,68
1400000US36081003600,Census Tract 36,Queens, New York,102,312,91,221,1747,836,911,102,30,22,735,0,30,220,107,113
1400000US36081003800,Census Tract 38,Queens, New York,102,262,155,107,1539,645,894,41,24,14,302,91,238,206,89,117
1400000US36081004001,Census Tract 40.01,Queens, New York,102,297,142,155,1278,614,664,80,38,42,346,52,78,225,112,113
1400000US36081004200,Census Tract 42,Queens, New York,102,407,180,227,2704,1401,1303,40,18,27,227,149,96,268,115,154
1400000US36081005200,Census Tract 52,Queens, New York,102,452,140,312,1636,731,905,104,32,127,247,112,178,182,72,109
1400000US36081005400,Census Tract 54,Queens, New York,102,632,227,405,3565,1813,1752,139,50,85,802,192,142,357,187,168
1400000US36081010800,Census Tract 108,Queens, New York,102,362,150,212,1929,798,1131,92,38,35,610,110,149,228,85,143
1400000US36081011000,Census Tract 110,Queens, New York,102,179,111,68,2080,966,1114,42,26,15,551,140,194,210,80,130
1400000US36081011400,Census Tract 114,Queens, New York,102,82,77,5,646,291,355,0,0,0,0,21,0,99,38,61
1400000US36081011600,Census Tract 116,Queens, New York,102,209,79,130,1234,611,623,11,4,18,0,147,104,93,65,27
1400000US36081011800,Census Tract 118,Queens, New York,102,489,235,254,1724,933,791,19,9,8,81,57,102,428,337,91
1400000US36081012000,Census Tract 120,Queens, New York,102,310,185,125,1773,936,837,95,57,45,397,64,114,145,70,76
1400000US36081012200,Census Tract 122,Queens, New York,102,251,189,62,1769,804,965,59,44,12,628,91,101,492,264,228
1400000US36081012400,Census Tract 124,Queens, New York,102,214,98,116,1873,875,998,65,30,41,485,68,139,266,132,134
1400000US36081012601,Census Tract 126.01,Queens, New York,102,161,96,65,1690,806,884,31,19,21,0,52,118,203,89,113
1400000US36081012602,Census Tract 126.02,Queens, New York,102,188,69,119,1633,878,755,55,20,7,701,167,187,202,98,105
1400000US36081012800,Census Tract 128,Queens, New York,102,264,120,144,1263,587,676,0,0,0,0,0,18,111,42,69
1400000US36081013000,Census Tract 130,Queens, New York,102,240,146,94,1062,607,455,87,53,56,0,48,20,66,26,40
1400000US36081013200,Census Tract 132,Queens, New York,102,294,96,198,1061,541,520,0,0,0,0,0,22,12,2,10
1400000US36081013400,Census Tract 134,Queens, New York,102,338,137,201,3927,1888,2039,40,16,43,216,25,112,102,62,39
1400000US36081013600,Census Tract 136,Queens, New York,102,243,88,155,1358,584,774,77,28,60,376,31,31,77,13,65
1400000US36081013800,Census Tract 138,Queens, New York,102,421,178,243,2640,1343,1297,99,42,57,620,55,157,132,59,73
1400000US36081014000,Census Tract 140,Queens, New York,102,430,239,191,2391,1113,1278,10,5,8,0,47,81,160,14,146
1400000US36081014201,Census Tract 142.01,Queens, New York,102,616,379,237,3188,1554,1634,145,89,73,389,315,243,501,269,232
1400000US36081014202,Census Tract 142.02,Queens, New York,102,299,186,113,1862,1060,802,50,31,30,0,174,211,272,176,96
1400000US36081014400,Census Tract 144,Queens, New York,102,166,87,79,1038,502,536,37,19,16,250,109,67,217,105,112
1400000US36081014800,Census Tract 148,Queens, New York,102,383,155,228,1502,854,648,64,26,47,210,78,128,291,203,89
1400000US36081015000,Census Tract 150,Queens, New York,102,287,160,127,1514,710,804,78,44,57,71,107,94,230,116,114
1400000US36081015200,Census Tract 152,Queens, New York,102,350,143,207,1932,1014,918,56,23,43,243,250,156,253,162,92
1400000US36081015400,Census Tract 154,Queens, New York,102,210,154,56,1367,580,787,34,25,5,488,110,100,144,46,98
1400000US36081015600,Census Tract 156,Queens, New York,102,436,216,220,2052,1060,992,106,52,51,523,85,187,218,133,85
1400000US36081020600,Census Tract 206,Queens, New York,102,116,21,95,903,418,485,28,5,50,162,87,75,117,85,32
1400000US36081020800,Census Tract 208,Queens, New York,102,292,267,25,1827,908,919,161,147,14,585,195,115,334,181,153
1400000US36081021600,Census Tract 216,Queens, New York,102,312,202,110,3343,1784,1559,76,49,37,244,103,143,314,111,203
1400000US36081022001,Census Tract 220.01,Queens, New York,102,544,338,206,4477,1895,2582,28,17,12,197,99,41,381,153,230
1400000US36081038302,Census Tract 383.02,Queens, New York,102,10,0,10,92,24,68,0,0,0,0,0,18,17,0,17
1400000US36081064101,Census Tract 641.01,Queens, New York,102,134,74,60,1485,715,770,0,0,0,0,9,12,169,47,122
1400000US36081064102,Census Tract 641.02,Queens, New York,102,12,0,12,84,33,51,0,0,0,0,0,0,26,13,13
1400000US36081074900,Census Tract 749,Queens, New York,102,187,72,115,1137,586,551,4,2,0,40,9,30,0,0,0
1400000US36081076901,Census Tract 769.01,Queens, New York,102,76,52,24,3179,1269,1910,0,0,0,0,44,57,32,15,17
1400000US36081076902,Census Tract 769.02,Queens, New York,102,130,0,130,988,477,511,0,0,0,0,18,9,15,15,0
1400000US36081077300,Census Tract 773,Queens, New York,102,209,109,100,1764,934,830,0,0,0,0,35,4,60,21,39
1400000US36081077500,Census Tract 775,Queens, New York,102,229,80,149,1585,735,850,16,6,0,170,0,89,84,42,42
1400000US36081019800,Census Tract 198,Queens, New York,103,244,161,83,1912,927,985,72,47,27,461,136,183,315,129,187
1400000US36081020400,Census Tract 204,Queens, New York,103,212,97,115,1263,477,786,116,53,65,669,19,129,145,117,28
1400000US36081021200,Census Tract 212,Queens, New York,103,246,102,144,1782,766,1016,67,28,88,62,256,362,488,187,301
1400000US36081021400,Census Tract 214,Queens, New York,103,374,124,250,3826,1934,1892,54,18,109,0,220,202,341,261,79
1400000US36081023600,Census Tract 236,Queens, New York,103,257,125,132,1839,944,895,120,58,67,794,103,210,272,124,149
1400000US36081023800,Census Tract 238,Queens, New York,103,437,273,164,2708,1369,1339,123,77,74,0,394,183,233,81,153
1400000US36081024000,Census Tract 240,Queens, New York,103,529,192,337,3500,1551,1949,131,48,105,739,372,458,431,102,327
1400000US36081024600,Census Tract 246,Queens, New York,103,0,0,0,0,0,0,0,0,0,0,0,0,0,0,0
1400000US36081025400,Census Tract 254,Queens, New York,103,1286,670,616,4569,1969,2600,368,192,176,1311,378,335,941,441,502
1400000US36081025800,Census Tract 258,Queens, New York,103,190,115,75,810,338,472,22,13,5,151,46,12,148,31,117
1400000US36081026000,Census Tract 260,Queens, New York,103,197,105,92,1332,529,803,59,31,26,420,36,41,186,67,119
1400000US36081041400,Census Tract 414,Queens, New York,103,103,66,37,2250,959,1291,25,16,7,790,119,67,299,115,185
1400000US36081044000,Census Tract 440,Queens, New York,103,440,180,260,2114,834,1280,191,78,153,691,128,140,178,76,101
1400000US36081044400,Census Tract 444,Queens, New York,103,164,90,74,1696,739,957,0,0,0,0,129,159,348,189,159
1400000US36081044601,Census Tract 446.01,Queens, New York,103,175,96,79,2008,830,1178,22,12,18,0,200,316,211,130,80
1400000US36081046000,Census Tract 460,Queens, New York,103,484,278,206,3828,1756,2072,166,95,76,1171,304,340,364,88,276
1400000US36081046200,Census Tract 462,Queens, New York,103,708,298,410,4636,1997,2639,54,23,14,496,357,528,709,335,372
1400000US36081046600,Census Tract 466,Queens, New York,103,334,94,240,2205,965,1240,0,0,0,0,45,78,168,106,62
1400000US36081046800,Census Tract 468,Queens, New York,103,296,202,94,2492,1168,1324,99,67,46,0,279,351,396,172,225
1400000US36081047000,Census Tract 470,Queens, New York,103,359,153,206,2228,1224,1004,10,4,13,0,228,224,305,188,118
1400000US36081048000,Census Tract 480,Queens, New York,103,260,162,98,1815,1017,798,12,7,7,0,142,129,287,151,135
1400000US36081048200,Census Tract 482,Queens, New York,103,67,45,22,1288,591,697,10,7,5,0,88,106,82,55,27
1400000US36081048400,Census Tract 484,Queens, New York,103,546,245,301,3463,1621,1842,135,61,124,391,151,258,260,130,127
1400000US36081050000,Census Tract 500,Queens, New York,103,465,198,267,2873,1227,1646,107,46,80,517,144,127,523,275,249
1400000US36081050201,Census Tract 502.01,Queens, New York,103,262,138,124,1146,460,686,73,39,0,675,62,118,46,34,12
1400000US36081050202,Census Tract 502.02,Queens, New York,103,181,127,54,1017,382,635,14,10,0,245,31,46,103,47,56
1400000US36047114201,Census Tract 1142.01,Brooklyn, New York,104,167,88,79,976,526,450,38,20,0,469,54,48,208,126,82
1400000US36081021900,Census Tract 219,Queens, New York,104,0,0,0,0,0,0,0,0,0,0,0,0,0,0,0
1400000US36081049301,Census Tract 493.01,Queens, New York,104,31,21,10,1322,677,645,10,7,0,1322,40,31,50,36,14
1400000US36081049302,Census Tract 493.02,Queens, New York,104,126,62,64,1629,795,834,11,5,11,0,136,70,176,96,80
1400000US36081049500,Census Tract 495,Queens, New York,104,87,51,36,1188,527,661,0,0,0,0,37,72,125,76,49
1400000US36081049700,Census Tract 497,Queens, New York,104,222,108,114,2268,1072,1196,94,46,57,796,169,108,367,168,200
1400000US36081050500,Census Tract 505,Queens, New York,104,206,44,162,1332,683,649,119,25,133,682,63,185,151,137,13
1400000US36081050700,Census Tract 507,Queens, New York,104,210,145,65,2604,1223,1381,11,8,0,401,177,209,128,42,86
1400000US36081051100,Census Tract 511,Queens, New York,104,223,86,137,1503,695,808,24,9,38,0,39,109,125,51,73
1400000US36081051300,Census Tract 513,Queens, New York,104,200,143,57,1409,778,631,5,4,0,124,49,6,210,94,116
1400000US36081051500,Census Tract 515,Queens, New York,104,115,44,71,2050,1039,1011,0,0,0,0,12,42,215,145,71
1400000US36081051700,Census Tract 517,Queens, New York,104,153,77,76,1329,678,651,0,0,0,0,0,29,234,141,93
1400000US36081052100,Census Tract 521,Queens, New York,104,144,67,77,1114,548,566,18,8,21,0,12,71,20,10,10
1400000US36081052500,Census Tract 525,Queens, New York,104,181,102,79,1414,713,701,9,5,4,72,63,60,105,69,36
1400000US36081053100,Census Tract 531,Queens, New York,104,396,128,268,2347,1064,1283,29,9,0,253,38,38,277,140,139
1400000US36081053500,Census Tract 535,Queens, New York,104,78,51,27,833,485,348,19,12,0,586,39,21,227,180,47
1400000US36081053900,Census Tract 539,Queens, New York,104,390,148,242,2841,1404,1437,12,5,0,142,80,170,344,232,114
1400000US36081054500,Census Tract 545,Queens, New York,104,324,129,195,2375,1215,1160,170,68,121,1097,254,298,330,179,152
1400000US36081054700,Census Tract 547,Queens, New York,104,554,302,252,2728,1284,1444,172,94,113,390,381,371,385,149,235
1400000US36081054900,Census Tract 549,Queens, New York,104,758,264,494,3284,1677,1607,167,58,211,358,297,379,640,416,225
1400000US36081055100,Census Tract 551,Queens, New York,104,610,372,238,2849,1401,1448,139,85,43,863,172,282,336,165,169
1400000US36081055300,Census Tract 553,Queens, New York,104,266,105,161,1271,656,615,37,15,35,111,78,123,250,174,76
1400000US36081055500,Census Tract 555,Queens, New York,104,366,201,165,1547,847,700,17,9,14,0,181,157,244,136,108
1400000US36081055700,Census Tract 557,Queens, New York,104,586,315,271,2942,1456,1486,78,42,67,0,248,324,253,137,117
1400000US36081055900,Census Tract 559,Queens, New York,104,114,74,40,609,271,338,52,34,11,487,79,44,9,9,0
1400000US36081056100,Census Tract 561,Queens, New York,104,12,0,12,55,28,27,0,0,0,0,5,0,0,0,0
1400000US36081056500,Census Tract 565,Queens, New York,104,109,73,36,779,389,390,7,5,0,151,88,30,57,7,50
1400000US36081056700,Census Tract 567,Queens, New York,104,566,321,245,3050,1508,1542,51,29,39,0,104,205,238,155,83
1400000US36081057700,Census Tract 577,Queens, New York,104,415,156,259,2779,1374,1405,31,12,52,0,71,163,258,129,131
1400000US36081057900,Census Tract 579,Queens, New York,104,132,12,120,828,301,527,61,6,0,421,0,86,85,35,50
1400000US36081058100,Census Tract 581,Queens, New York,104,262,209,53,1748,797,951,23,18,4,264,126,162,91,31,60
1400000US36081058300,Census Tract 583,Queens, New York,104,442,188,254,2378,1106,1272,47,20,0,440,121,65,243,96,146
1400000US36081058500,Census Tract 585,Queens, New York,104,460,282,178,2726,1367,1359,60,37,22,382,48,174,213,126,87
1400000US36081058700,Census Tract 587,Queens, New York,104,383,133,250,2114,996,1118,91,32,120,228,108,141,228,63,165
1400000US36081058900,Census Tract 589,Queens, New York,104,501,236,265,2857,1420,1437,83,39,44,474,30,45,180,62,116
1400000US36081059100,Census Tract 591,Queens, New York,104,558,226,332,3328,1492,1836,60,24,48,270,280,330,506,246,261
1400000US36081059300,Census Tract 593,Queens, New York,104,399,251,148,2515,1221,1294,27,17,16,0,83,129,196,49,148
1400000US36081059500,Census Tract 595,Queens, New York,104,542,274,268,3347,1580,1767,33,17,16,211,147,262,315,164,152
1400000US36081059900,Census Tract 599,Queens, New York,104,160,46,114,1044,509,535,0,0,0,0,22,48,124,56,68
1400000US36081060100,Census Tract 601,Queens, New York,104,190,67,123,1306,656,650,51,18,26,393,24,57,192,108,84
1400000US36081060300,Census Tract 603,Queens, New York,104,120,40,80,1349,693,656,0,0,0,0,9,10,115,54,61
1400000US36081060701,Census Tract 607.01,Queens, New York,104,0,0,0,0,0,0,0,0,0,0,0,0,0,0,0
1400000US36081061301,Census Tract 613.01,Queens, New York,104,227,71,156,3676,1934,1742,0,0,0,0,172,253,338,199,139
1400000US36081061302,Census Tract 613.02,Queens, New York,104,0,0,0,27,0,27,0,0,0,0,0,0,0,0,0
1400000US36081061900,Census Tract 619,Queens, New York,104,276,113,163,2190,1099,1091,9,4,0,120,38,75,265,167,98
1400000US36081062100,Census Tract 621,Queens, New York,104,231,147,84,1778,676,1102,0,0,0,0,48,110,174,52,123
1400000US36081062300,Census Tract 623,Queens, New York,104,70,41,29,1401,602,799,19,11,10,241,17,67,91,47,44
1400000US36081062500,Census Tract 625,Queens, New York,104,179,48,131,1574,777,797,9,2,25,0,33,18,168,88,80
1400000US36081062700,Census Tract 627,Queens, New York,104,219,78,141,1841,945,896,29,10,27,182,60,21,226,100,127
1400000US36081062900,Census Tract 629,Queens, New York,104,281,174,107,1857,776,1081,37,23,18,121,39,32,225,81,143
1400000US36081063301,Census Tract 633.01,Queens, New York,104,46,28,18,894,456,438,0,0,0,0,35,74,82,82,0
1400000US36081063302,Census Tract 633.02,Queens, New York,104,93,40,53,1219,490,729,0,0,0,0,9,36,76,34,41
1400000US36081063500,Census Tract 635,Queens, New York,104,243,133,110,1516,731,785,21,11,17,0,30,71,74,35,40
1400000US36081063700,Census Tract 637,Queens, New York,104,287,120,167,2283,898,1385,4,2,0,55,66,134,167,44,123
1400000US36081063900,Census Tract 639,Queens, New York,104,397,176,221,2016,834,1182,9,4,11,0,93,85,141,88,53
1400000US36081065501,Census Tract 655.01,Queens, New York,104,0,0,0,0,0,0,0,0,0,0,0,0,0,0,0
1400000US36081065702,Census Tract 657.02,Queens, New York,104,81,43,38,1112,509,603,12,6,0,351,25,68,196,126,70
1400000US36081065703,Census Tract 657.03,Queens, New York,104,190,128,62,1921,984,937,7,5,2,61,44,104,113,75,39
1400000US36081065900,Census Tract 659,Queens, New York,104,114,96,18,1263,559,704,0,0,0,0,21,46,81,23,58
1400000US36081066100,Census Tract 661,Queens, New York,104,54,20,34,1142,441,701,11,4,19,0,18,77,69,43,26
1400000US36081066300,Census Tract 663,Queens, New York,104,225,132,93,1839,781,1058,54,32,31,199,0,88,154,67,88
1400000US36081066501,Census Tract 665.01,Queens, New York,104,266,122,144,2571,1207,1364,34,16,40,0,142,116,306,196,110
1400000US36081066701,Census Tract 667.01,Queens, New York,104,139,86,53,2001,903,1098,19,12,12,0,33,85,178,82,97
1400000US36081066900,Census Tract 669,Queens, New York,104,100,48,52,1440,622,818,9,4,0,249,49,49,117,34,83
1400000US36081067100,Census Tract 671,Queens, New York,104,202,64,138,1564,832,732,21,7,19,136,78,111,127,86,41
1400000US36081067700,Census Tract 677,Queens, New York,104,222,171,51,1280,665,615,0,0,0,0,20,19,70,33,38
1400000US36081067900,Census Tract 679,Queens, New York,104,255,105,150,3319,1266,2053,36,15,41,156,66,289,226,108,117
1400000US36081032000,Census Tract 320,Queens, New York,105,563,252,311,2762,1336,1426,227,102,100,1295,53,108,309,154,155
1400000US36081035800,Census Tract 358,Queens, New York,105,528,300,228,2675,1169,1506,151,86,73,645,65,62,313,109,203
1400000US36081037600,Census Tract 376,Queens, New York,105,579,275,304,4052,1687,2365,119,57,60,867,34,111,308,181,128
1400000US36081049600,Census Tract 496,Queens, New York,105,380,144,236,1955,976,979,58,22,61,174,10,86,196,82,113
1400000US36081051200,Census Tract 512,Queens, New York,105,406,183,223,1846,767,1079,124,56,23,869,110,73,89,19,69
1400000US36081051600,Census Tract 516,Queens, New York,105,309,201,108,1298,585,713,88,57,47,0,27,39,121,91,30
1400000US36081053401,Census Tract 534.01,Queens, New York,105,216,65,151,1905,766,1139,32,10,12,341,8,177,82,71,11
1400000US36081053601,Census Tract 536.01,Queens, New York,105,316,106,210,1020,419,601,14,5,28,0,4,46,73,51,22
1400000US36081053800,Census Tract 538,Queens, New York,105,257,69,188,1326,540,786,57,15,0,402,33,47,111,54,57
1400000US36081054000,Census Tract 540,Queens, New York,105,663,379,284,2842,1311,1531,126,72,28,881,7,119,367,228,139
1400000US36081054200,Census Tract 542,Queens, New York,105,646,298,348,3709,1725,1984,38,18,12,297,204,123,363,167,194
1400000US36081054800,Census Tract 548,Queens, New York,105,322,215,107,1686,836,850,51,34,20,157,68,23,133,73,60
1400000US36081055400,Census Tract 554,Queens, New York,105,323,249,74,1866,983,883,142,110,30,1060,113,64,174,100,74
1400000US36081055600,Census Tract 556,Queens, New York,105,306,187,119,1684,800,884,65,40,26,340,32,55,253,122,131
1400000US36081055800,Census Tract 558,Queens, New York,105,289,150,139,1269,594,675,0,0,0,0,23,52,100,53,47
1400000US36081056000,Census Tract 560,Queens, New York,105,219,139,80,1172,544,628,12,8,0,176,54,23,52,38,14
1400000US36081056200,Census Tract 562,Queens, New York,105,111,26,85,1326,672,654,7,2,23,0,116,58,76,50,25
1400000US36081056400,Census Tract 564,Queens, New York,105,96,67,29,1312,655,657,8,6,0,362,51,59,109,52,57
1400000US36081056600,Census Tract 566,Queens, New York,105,202,112,90,1107,569,538,116,64,59,529,70,118,97,45,52
1400000US36081056800,Census Tract 568,Queens, New York,105,481,343,138,3684,1733,1951,123,88,49,52,154,131,265,187,78
1400000US36081058000,Census Tract 580,Queens, New York,105,445,250,195,2659,1302,1357,76,43,14,790,89,100,247,116,132
1400000US36081058200,Census Tract 582,Queens, New York,105,391,188,203,3659,1674,1985,155,74,78,1497,84,163,220,116,105
1400000US36081059000,Census Tract 590,Queens, New York,105,185,106,79,943,385,558,16,9,12,0,38,37,151,98,53
1400000US36081059200,Census Tract 592,Queens, New York,105,83,14,69,1049,399,650,0,0,0,0,8,10,103,49,54
1400000US36081059400,Census Tract 594,Queens, New York,105,98,61,37,1207,548,659,0,0,0,0,27,39,29,21,8
1400000US36081059600,Census Tract 596,Queens, New York,105,124,11,113,1187,664,523,32,3,0,336,0,15,37,15,22
1400000US36081059800,Census Tract 598,Queens, New York,105,213,141,72,1284,589,695,0,0,0,0,86,68,100,47,53
1400000US36081060000,Census Tract 600,Queens, New York,105,142,85,57,680,318,362,43,26,29,0,0,0,41,16,25
1400000US36081060600,Census Tract 606,Queens, New York,105,148,69,79,829,393,436,16,7,18,0,0,32,79,38,41
1400000US36081060800,Census Tract 608,Queens, New York,105,179,69,110,1385,609,776,0,0,0,0,25,44,80,65,16
1400000US36081061000,Census Tract 610,Queens, New York,105,405,246,159,1165,498,667,62,38,40,0,7,0,82,35,47
1400000US36081061200,Census Tract 612,Queens, New York,105,126,28,98,1162,455,707,0,0,0,0,10,0,76,60,16
1400000US36081061400,Census Tract 614,Queens, New York,105,131,72,59,1059,490,569,54,30,31,287,16,31,128,50,78
1400000US36081061601,Census Tract 616.01,Queens, New York,105,188,78,110,1591,686,905,0,0,0,0,8,19,83,48,35
1400000US36081061602,Census Tract 616.02,Queens, New York,105,146,67,79,859,451,408,35,16,15,239,0,0,73,33,40
1400000US36081061800,Census Tract 618,Queens, New York,105,61,28,33,1014,474,540,0,0,0,0,25,18,81,27,54
1400000US36081062000,Census Tract 620,Queens, New York,105,125,87,38,1086,520,566,9,6,4,0,23,9,12,12,0
1400000US36081062200,Census Tract 622,Queens, New York,105,189,63,126,1482,596,886,6,2,12,0,94,25,194,100,94
1400000US36081062400,Census Tract 624,Queens, New York,105,0,0,0,0,0,0,0,0,0,0,0,0,0,0,0
1400000US36081062600,Census Tract 626,Queens, New York,105,178,42,136,2251,835,1416,0,0,0,0,41,79,362,92,270
1400000US36081063000,Census Tract 630,Queens, New York,105,166,99,67,1147,487,660,43,26,22,188,14,74,109,47,62
1400000US36081063200,Census Tract 632,Queens, New York,105,183,77,106,1393,467,926,23,10,32,0,23,58,102,0,101
1400000US36081063800,Census Tract 638,Queens, New York,105,342,156,186,2397,1079,1318,23,10,12,168,100,127,129,49,80
1400000US36081064600,Census Tract 646,Queens, New York,105,182,91,91,1995,799,1196,9,4,9,0,103,43,251,138,112
1400000US36081065000,Census Tract 650,Queens, New York,105,221,87,134,2064,902,1162,23,9,0,355,0,28,167,55,113
1400000US36081065400,Census Tract 654,Queens, New York,105,403,266,137,1935,794,1141,51,34,26,0,0,21,116,57,60
1400000US36081065600,Census Tract 656,Queens, New York,105,580,232,348,2950,1240,1710,130,52,119,434,72,152,139,50,89
1400000US36081066000,Census Tract 660,Queens, New York,105,393,232,161,2142,903,1239,7,4,0,92,68,64,208,69,138
1400000US36081068000,Census Tract 680,Queens, New York,105,491,272,219,3289,1460,1829,65,36,40,224,66,22,260,172,88
1400000US36081068200,Census Tract 682,Queens, New York,105,250,68,182,744,319,425,43,12,19,147,14,0,34,16,18
1400000US36081069000,Census Tract 690,Queens, New York,105,475,239,236,2251,984,1267,102,51,90,106,38,30,342,189,155
1400000US36081069400,Census Tract 694,Queens, New York,105,249,121,128,1743,662,1081,34,17,36,0,49,37,164,35,129
1400000US36081138502,Census Tract 1385.02,Queens, New York,105,7,7,0,26,26,0,0,0,0,0,0,0,0,0,0
1400000US36081152901,Census Tract 1529.01,Queens, New York,105,303,73,230,4799,2278,2521,0,0,0,0,114,88,125,46,81
1400000US36081152902,Census Tract 1529.02,Queens, New York,105,292,238,54,4177,1951,2226,0,0,0,0,49,53,175,47,129
1400000US36081155101,Census Tract 1551.01,Queens, New York,105,0,0,0,1797,631,1166,0,0,0,0,9,12,40,28,10
1400000US36081155102,Census Tract 1551.02,Queens, New York,105,372,129,243,5977,2683,3294,90,31,8,2116,126,89,269,126,142
1400000US36081156700,Census Tract 1567,Queens, New York,105,63,31,32,1093,689,404,4,2,4,0,159,104,74,71,3
1400000US36081157101,Census Tract 1571.01,Queens, New York,105,661,411,250,5251,2578,2673,35,22,16,189,54,190,189,49,142
1400000US36081157102,Census Tract 1571.02,Queens, New York,105,100,59,41,1329,632,697,48,28,26,356,48,42,124,41,82
1400000US36081157901,Census Tract 1579.01,Queens, New York,105,488,304,184,3743,1708,2035,58,36,29,202,56,147,127,53,75
1400000US36081157902,Census Tract 1579.02,Queens, New York,105,339,157,182,2743,1261,1482,52,24,16,573,48,90,269,127,142
1400000US36081157903,Census Tract 1579.03,Queens, New York,105,374,130,244,2883,1289,1594,68,24,82,283,58,166,159,86,72
1400000US36081161700,Census Tract 1617,Queens, New York,105,402,229,173,3123,1624,1499,16,9,12,0,36,49,141,123,16
1400000US36081162100,Census Tract 1621,Queens, New York,105,569,372,197,4335,1970,2365,51,33,10,702,83,151,282,130,151
1400000US36081004002,Census Tract 40.02,Queens, New York,106,208,176,32,669,375,294,28,24,5,0,30,65,32,19,13
1400000US36081004401,Census Tract 44.01,Queens, New York,106,493,318,175,2120,1086,1034,43,28,10,303,167,149,172,24,147
1400000US36081005000,Census Tract 50,Queens, New York,106,0,0,0,0,0,0,0,0,0,0,0,0,0,0,0
1400000US36081005800,Census Tract 58,Queens, New York,106,448,192,256,4128,1994,2134,46,20,61,0,44,156,330,231,98
1400000US36081006201,Census Tract 62.01,Queens, New York,106,167,102,65,4817,1914,2903,56,34,25,1262,124,139,607,358,253
1400000US36081008600,Census Tract 86,Queens, New York,106,246,184,62,1716,669,1047,0,0,0,0,117,117,204,81,122
1400000US36081008800,Census Tract 88,Queens, New York,106,272,153,119,2169,1004,1165,49,28,35,74,22,89,208,98,110
1400000US36081009400,Census Tract 94,Queens, New York,106,441,207,234,1761,836,925,149,70,155,90,174,114,370,174,195
1400000US36081009600,Census Tract 96,Queens, New York,106,298,202,96,2247,1116,1131,8,5,0,187,194,170,191,137,55
1400000US36081009800,Census Tract 98,Queens, New York,106,265,128,137,1633,875,758,69,33,49,274,154,132,183,62,121
1400000US36081010000,Census Tract 100,Queens, New York,106,434,158,276,2205,1138,1067,65,24,47,304,112,170,187,90,98
1400000US36081010200,Census Tract 102,Queens, New York,106,438,269,169,1746,747,999,169,104,85,351,97,146,267,135,133
1400000US36081010400,Census Tract 104,Queens, New York,106,450,195,255,2577,1164,1413,81,35,93,101,142,374,443,143,301
1400000US36081010600,Census Tract 106,Queens, New York,106,392,138,254,2041,1102,939,50,18,46,200,136,227,253,177,76
1400000US36081011200,Census Tract 112,Queens, New York,106,208,101,107,1463,588,875,57,28,40,260,18,101,247,144,103
1400000US36081015801,Census Tract 158.01,Queens, New York,106,276,111,165,2164,937,1227,16,6,0,210,110,220,173,117,56
1400000US36081015802,Census Tract 158.02,Queens, New York,106,617,289,328,2866,1464,1402,11,5,0,97,242,294,361,203,158
1400000US36081016400,Census Tract 164,Queens, New York,106,313,147,166,2399,1101,1298,19,9,21,0,255,347,173,86,86
1400000US36081016600,Census Tract 166,Queens, New York,106,448,236,212,2689,1309,1380,142,75,110,242,262,279,325,137,188
1400000US36081016800,Census Tract 168,Queens, New York,106,367,154,213,2045,953,1092,20,8,14,96,129,198,260,133,127
1400000US36081017000,Census Tract 170,Queens, New York,106,259,125,134,1430,633,797,22,11,13,107,92,139,139,59,80
1400000US36081017200,Census Tract 172,Queens, New York,106,195,84,111,1288,594,694,29,13,19,174,92,125,191,103,87
1400000US36081017400,Census Tract 174,Queens, New York,106,238,169,69,1815,773,1042,16,11,2,263,93,126,198,129,69
1400000US36081017600,Census Tract 176,Queens, New York,106,238,134,104,1226,602,624,58,33,30,235,35,59,179,81,98
1400000US36081017800,Census Tract 178,Queens, New York,106,318,156,162,1378,607,771,38,19,40,0,34,15,187,69,118
1400000US36081018000,Census Tract 180,Queens, New York,106,84,56,28,780,398,382,0,0,0,0,101,7,44,37,7
1400000US36081020200,Census Tract 202,Queens, New York,106,136,59,77,979,404,575,38,16,50,0,44,80,5,0,5
1400000US36081030600,Census Tract 306,Queens, New York,106,540,237,303,2611,976,1635,67,29,72,94,54,10,243,65,178
1400000US36081071600,Census Tract 716,Queens, New York,106,0,0,0,0,0,0,0,0,0,0,0,0,0,0,0
1400000US36081079200,Census Tract 792,Queens, New York,106,167,66,101,1296,560,736,12,5,18,0,34,57,70,33,37
1400000US36081081400,Census Tract 814,Queens, New York,106,387,233,154,2217,1097,1120,144,87,68,590,63,96,361,202,160
1400000US36081081800,Census Tract 818,Queens, New York,106,295,191,104,2325,1148,1177,53,34,25,156,59,97,279,177,102
1400000US36081083800,Census Tract 838,Queens, New York,106,610,207,403,3825,1793,2032,71,24,47,448,70,224,268,117,150
1400000US36081084000,Census Tract 840,Queens, New York,106,796,362,434,4323,2133,2190,160,73,55,1137,143,276,497,190,307
1400000US36081084601,Census Tract 846.01,Queens, New York,106,260,193,67,2289,1068,1221,65,48,14,854,83,264,256,143,114
1400000US36081084602,Census Tract 846.02,Queens, New York,106,56,5,51,743,385,358,0,0,0,0,90,113,93,49,44
1400000US36081086400,Census Tract 864,Queens, New York,106,272,160,112,1480,676,804,16,9,9,40,46,80,120,49,71
1400000US36081088400,Census Tract 884,Queens, New York,106,475,314,161,5439,2473,2966,99,65,28,1485,131,279,696,376,320
1400000US36081089200,Census Tract 892,Queens, New York,106,673,374,299,6639,3254,3385,73,40,32,730,238,301,664,270,393
1400000US36081022002,Census Tract 220.02,Queens, New York,107,666,324,342,4088,2014,2074,58,28,61,0,213,191,245,183,60
1400000US36081023000,Census Tract 230,Queens, New York,107,186,71,115,1315,669,646,21,8,0,241,44,84,142,62,80
1400000US36081023200,Census Tract 232,Queens, New York,107,389,218,171,3919,1833,2086,33,19,12,411,189,269,368,115,254
1400000US36081044602,Census Tract 446.02,Queens, New York,107,506,303,203,2794,1383,1411,136,82,27,1322,104,206,324,133,190
1400000US36081044800,Census Tract 448,Queens, New York,107,273,194,79,1570,839,731,152,108,62,0,117,105,118,70,48
1400000US36081045000,Census Tract 450,Queens, New York,107,161,116,45,1185,640,545,77,55,17,843,96,123,70,38,32
1400000US36081045200,Census Tract 452,Queens, New York,107,129,79,50,885,285,600,0,0,0,0,21,122,86,32,54
1400000US36081045400,Census Tract 454,Queens, New York,107,699,450,249,2849,1510,1339,87,56,48,0,116,126,188,106,83
1400000US36081045600,Census Tract 456,Queens, New York,107,111,40,71,879,432,447,0,0,0,0,14,34,63,25,38
1400000US36081045800,Census Tract 458,Queens, New York,107,344,79,265,1276,527,749,14,3,0,68,39,85,71,0,71
1400000US36081046400,Census Tract 464,Queens, New York,107,201,38,163,1069,531,538,13,2,0,86,29,12,24,5,18
1400000US36081047200,Census Tract 472,Queens, New York,107,212,81,131,2584,1018,1566,19,7,31,0,123,106,150,56,96
1400000US36081047600,Census Tract 476,Queens, New York,107,71,18,53,1095,555,540,32,8,0,661,32,31,4,4,0
1400000US36081047800,Census Tract 478,Queens, New York,107,251,59,192,3963,1915,2048,0,0,0,0,111,129,594,283,311
1400000US36081049200,Census Tract 492,Queens, New York,107,385,221,164,3300,1318,1982,12,7,8,20,107,178,277,188,89
1400000US36081055200,Census Tract 552,Queens, New York,107,351,80,271,2329,1243,1086,96,22,54,687,55,135,268,85,182
1400000US36081077902,Census Tract 779.02,Queens, New York,107,501,249,252,2945,1511,1434,25,12,6,221,44,39,62,35,26
1400000US36081077903,Census Tract 779.03,Queens, New York,107,148,78,70,2014,962,1052,13,7,0,375,9,55,117,27,90
1400000US36081077904,Census Tract 779.04,Queens, New York,107,701,355,346,3591,1652,1939,15,7,15,0,89,101,172,78,93
1400000US36081077905,Census Tract 779.05,Queens, New York,107,265,155,110,1977,746,1231,0,0,0,0,43,22,71,44,28
1400000US36081077906,Census Tract 779.06,Queens, New York,107,167,36,131,2370,1048,1322,0,0,0,0,93,130,161,99,62
1400000US36081077907,Census Tract 779.07,Queens, New York,107,346,111,235,1916,938,978,45,14,38,220,17,66,92,67,25
1400000US36081077908,Census Tract 779.08,Queens, New York,107,505,241,264,2199,1096,1103,64,31,39,233,34,202,40,39,0
1400000US36081079300,Census Tract 793,Queens, New York,107,0,0,0,0,0,0,0,0,0,0,0,0,0,0,0
1400000US36081080302,Census Tract 803.02,Queens, New York,107,217,144,73,2085,949,1136,41,27,17,229,59,68,138,65,73
1400000US36081080900,Census Tract 809,Queens, New York,107,543,192,351,4610,2107,2503,20,7,0,263,59,100,350,122,228
1400000US36081122300,Census Tract 1223,Queens, New York,107,331,194,137,2596,1220,1376,20,12,14,0,70,87,166,32,135
1400000US36081124100,Census Tract 1241,Queens, New York,107,381,174,207,2689,1312,1377,25,11,30,0,96,128,191,84,106
1400000US36081124700,Census Tract 1247,Queens, New York,107,350,195,155,2632,1117,1515,37,21,29,0,63,186,95,74,23
1400000US36081125700,Census Tract 1257,Queens, New York,107,344,220,124,2520,1160,1360,0,0,0,0,114,103,174,97,78
1400000US36081126500,Census Tract 1265,Queens, New York,107,183,105,78,1045,426,619,0,0,0,0,59,36,93,29,64
1400000US36081126700,Census Tract 1267,Queens, New York,107,1588,691,897,1556,832,724,0,0,0,0,5,14,47,28,18
1400000US36081127700,Census Tract 1277,Queens, New York,107,291,120,171,2341,1091,1250,52,21,36,370,38,15,21,21,0
1400000US36081133300,Census Tract 1333,Queens, New York,107,307,215,92,2542,1333,1209,1,1,0,28,23,66,71,19,51
1400000US36081133900,Census Tract 1339,Queens, New York,107,159,74,85,1022,484,538,0,0,0,0,0,45,61,51,10
1400000US36081134100,Census Tract 1341,Queens, New York,107,167,62,105,2494,1144,1350,0,0,0,0,224,159,197,78,119
1400000US36081000100,Census Tract 1,Queens, New York,108,440,184,256,3409,1844,1565,20,8,28,0,13,25,44,33,13
1400000US36081000700,Census Tract 7,Queens, New York,108,198,55,143,3283,1616,1667,19,5,49,0,57,55,121,87,33
1400000US36081001900,Census Tract 19,Queens, New York,108,64,64,0,663,307,356,33,33,0,0,30,45,12,0,12
1400000US36081002500,Census Tract 25,Queens, New York,108,714,414,300,4344,1477,2867,166,96,89,621,267,571,969,414,556
1400000US36081003700,Census Tract 37,Queens, New York,108,0,0,0,0,0,0,0,0,0,0,0,0,0,0,0
1400000US36081016900,Census Tract 169,Queens, New York,108,275,144,131,4213,2015,2198,52,27,32,548,107,244,539,337,204
1400000US36081017100,Census Tract 171,Queens, New York,108,0,0,0,0,0,0,0,0,0,0,0,0,0,0,0
1400000US36081017900,Census Tract 179,Queens, New York,108,79,47,32,781,417,364,33,20,22,0,60,89,44,6,38
1400000US36081018101,Census Tract 181.01,Queens, New York,108,385,138,247,3172,1619,1553,14,5,25,0,154,245,143,76,68
1400000US36081018102,Census Tract 181.02,Queens, New York,108,305,161,144,3010,1392,1618,13,7,0,271,173,197,160,74,86
1400000US36081018300,Census Tract 183,Queens, New York,108,310,92,218,4509,2044,2465,36,11,2,726,114,207,158,33,126
1400000US36081018501,Census Tract 185.01,Queens, New York,108,249,37,212,2640,1348,1292,24,4,0,298,24,118,356,262,96
1400000US36081018502,Census Tract 185.02,Queens, New York,108,314,110,204,2765,1241,1524,11,4,20,0,53,73,210,122,88
1400000US36081018700,Census Tract 187,Queens, New York,108,209,93,116,2282,1185,1097,25,11,0,493,100,163,180,81,100
1400000US36081018900,Census Tract 189,Queens, New York,108,197,69,128,2405,1093,1312,30,10,30,262,91,193,178,72,105
1400000US36081019900,Census Tract 199,Queens, New York,108,189,95,94,789,672,117,81,41,71,76,107,0,200,181,19
1400000US36081020500,Census Tract 205,Queens, New York,108,56,14,42,718,392,326,0,0,0,0,33,17,58,32,26
1400000US36081022900,Census Tract 229,Queens, New York,108,0,0,0,0,0,0,0,0,0,0,0,0,0,0,0
1400000US36081023500,Census Tract 235,Queens, New York,108,1381,673,708,5507,2819,2688,302,147,177,1052,569,672,793,527,266
1400000US36081024300,Census Tract 243,Queens, New York,108,380,219,161,3936,1865,2071,91,52,46,685,241,470,382,142,242
1400000US36081024500,Census Tract 245,Queens, New York,108,363,228,135,3736,1567,2169,1,1,1,0,216,308,340,212,130
1400000US36081024700,Census Tract 247,Queens, New York,108,154,114,40,1027,445,582,0,0,0,0,60,55,87,31,56
1400000US36081024900,Census Tract 249,Queens, New York,108,399,92,307,4705,2227,2478,58,13,193,0,269,384,442,131,312
1400000US36081025100,Census Tract 251,Queens, New York,108,568,375,193,4612,2352,2260,82,54,22,955,308,296,466,273,192
1400000US36081025301,Census Tract 253.01,Queens, New York,108,404,110,294,3137,1579,1558,3,1,0,31,313,238,72,28,44
1400000US36081025302,Census Tract 253.02,Queens, New York,108,179,50,129,2095,1118,977,0,0,0,0,91,101,210,117,93
1400000US36081025500,Census Tract 255,Queens, New York,108,147,99,48,817,417,400,10,7,0,170,32,11,116,77,39
1400000US36081025700,Census Tract 257,Queens, New York,108,57,41,16,1140,587,553,0,0,0,0,14,28,200,163,36
1400000US36081025900,Census Tract 259,Queens, New York,108,268,162,106,2619,1426,1193,81,49,31,841,183,197,312,118,193
1400000US36081026100,Census Tract 261,Queens, New York,108,448,186,262,5263,2799,2464,44,18,62,0,406,382,858,462,399
1400000US36081026300,Census Tract 263,Queens, New York,108,639,444,195,4286,2097,2189,174,121,76,0,201,405,407,241,166
1400000US36081029100,Census Tract 291,Queens, New York,108,555,365,190,4567,2216,2351,70,46,33,169,213,393,452,202,249
1400000US36081029300,Census Tract 293,Queens, New York,108,196,107,89,841,416,425,25,14,21,0,61,117,108,78,30
1400000US36081047900,Census Tract 479,Queens, New York,108,479,317,162,4445,2140,2305,24,16,8,249,188,300,685,379,309
1400000US36081048500,Census Tract 485,Queens, New York,108,461,280,181,3546,1802,1744,44,27,14,450,326,351,344,130,215
1400000US36081048900,Census Tract 489,Queens, New York,108,91,78,13,987,539,448,0,0,0,0,115,86,112,48,64
1400000US36081079701,Census Tract 797.01,Queens, New York,109,675,350,325,5068,2320,2748,53,28,0,826,58,352,279,102,176
1400000US36081079702,Census Tract 797.02,Queens, New York,109,373,234,139,2876,1353,1523,57,36,34,0,203,273,201,112,88
1400000US36081079900,Census Tract 799,Queens, New York,109,334,204,130,2416,1258,1158,8,5,5,0,142,188,312,192,119
1400000US36081080301,Census Tract 803.01,Queens, New York,109,417,175,242,3034,1530,1504,15,6,7,124,251,241,267,125,141
1400000US36081083700,Census Tract 837,Queens, New York,109,566,297,269,3920,1842,2078,40,21,12,392,249,262,333,131,202
1400000US36081084500,Census Tract 845,Queens, New York,109,627,322,305,3709,1603,2106,100,51,0,1217,157,227,334,138,198
1400000US36081084900,Census Tract 849,Queens, New York,109,728,352,376,4850,2571,2279,119,57,53,892,357,540,999,589,408
1400000US36081085300,Census Tract 853,Queens, New York,109,350,179,171,3566,1631,1935,105,54,64,792,248,252,471,264,205
1400000US36081085500,Census Tract 855,Queens, New York,109,347,149,198,5019,2256,2763,66,28,47,788,250,332,412,230,182
1400000US36081085700,Census Tract 857,Queens, New York,109,593,299,294,4676,2418,2258,105,53,25,1272,341,456,622,426,196
1400000US36081085900,Census Tract 859,Queens, New York,109,540,438,102,3996,1904,2092,60,49,14,0,307,347,444,228,215
1400000US36081086100,Census Tract 861,Queens, New York,109,258,92,166,1817,721,1096,28,10,5,274,70,132,243,113,130
1400000US36081086300,Census Tract 863,Queens, New York,109,658,441,217,5400,2597,2803,109,73,40,670,306,437,859,296,566
1400000US36081086500,Census Tract 865,Queens, New York,109,249,196,53,3522,1394,2128,138,109,37,0,130,292,321,100,219
1400000US36081086900,Census Tract 869,Queens, New York,109,220,134,86,1213,721,492,53,32,34,0,20,68,116,93,24
1400000US36081087100,Census Tract 871,Queens, New York,109,277,118,159,1262,357,905,35,15,9,222,55,128,138,34,104
1400000US36081088901,Census Tract 889.01,Queens, New York,109,566,307,259,7457,3248,4209,25,14,21,0,309,598,723,211,509
1400000US36081090700,Census Tract 907,Queens, New York,109,66,50,16,833,359,474,0,0,0,0,42,54,77,25,52
1400000US36081091900,Census Tract 919,Queens, New York,109,476,218,258,4428,2197,2231,61,28,39,483,294,308,368,160,210
1400000US36081092500,Census Tract 925,Queens, New York,109,207,60,147,2241,1038,1203,82,24,122,489,75,114,370,152,217
1400000US36081092900,Census Tract 929,Queens, New York,109,643,260,383,4584,2242,2342,31,12,22,193,143,185,367,195,171
1400000US36081093900,Census Tract 939,Queens, New York,109,382,174,208,2931,1440,1491,53,24,23,478,65,134,211,81,131
1400000US36081094500,Census Tract 945,Queens, New York,109,408,252,156,2734,1315,1419,71,44,31,369,124,142,186,107,81
1400000US36081094700,Census Tract 947,Queens, New York,109,177,79,98,1424,587,837,9,4,0,131,99,50,235,76,159
1400000US36081097300,Census Tract 973,Queens, New York,109,154,87,67,1604,685,919,23,13,18,0,46,26,109,73,36
1400000US36081098100,Census Tract 981,Queens, New York,109,210,147,63,1596,747,849,10,7,4,0,36,13,65,19,46
1400000US36081098700,Census Tract 987,Queens, New York,109,141,46,95,1938,870,1068,7,2,14,0,17,94,68,46,22
1400000US36081099100,Census Tract 991,Queens, New York,109,545,279,266,5015,2116,2899,57,29,19,697,95,99,211,146,64
1400000US36081099701,Census Tract 997.01,Queens, New York,109,124,55,69,1965,924,1041,11,5,14,0,17,25,88,54,34
1400000US36081099704,Census Tract 997.04,Queens, New York,109,141,79,62,6023,2564,3459,17,10,0,1650,18,121,235,100,135
1400000US36081099705,Census Tract 997.05,Queens, New York,109,316,203,113,2143,931,1212,34,22,9,321,21,28,56,17,39
1400000US36081099900,Census Tract 999,Queens, New York,109,0,0,0,0,0,0,0,0,0,0,0,0,0,0,0
1400000US36081101700,Census Tract 1017,Queens, New York,109,536,320,216,4235,2003,2232,0,0,0,0,72,225,220,104,116
1400000US36081102900,Census Tract 1029,Queens, New York,109,114,67,47,2776,1236,1540,0,0,0,0,78,240,358,151,206
1400000US36081103300,Census Tract 1033,Queens, New York,109,235,157,78,3010,1438,1572,10,7,5,0,144,130,151,62,86
1400000US36081103900,Census Tract 1039,Queens, New York,109,448,303,145,4395,2168,2227,26,18,12,0,143,187,316,100,218
1400000US36081104700,Census Tract 1047,Queens, New York,109,460,163,297,4489,1929,2560,25,9,4,346,89,230,265,122,143
1400000US36081105900,Census Tract 1059,Queens, New York,109,144,76,68,2820,1304,1516,3,2,0,124,51,109,206,83,121
1400000US36081108500,Census Tract 1085,Queens, New York,109,284,149,135,1982,900,1082,25,13,5,279,53,28,117,61,56
1400000US36081114100,Census Tract 1141,Queens, New York,109,141,120,21,1679,675,1004,26,22,5,0,17,104,72,26,46
1400000US36081114700,Census Tract 1147,Queens, New York,109,156,68,88,1478,620,858,30,13,5,436,9,76,61,41,19
1400000US36081115100,Census Tract 1151,Queens, New York,109,69,33,36,705,361,344,11,5,0,216,4,4,30,5,25
1400000US36081115500,Census Tract 1155,Queens, New York,109,177,103,74,1576,809,767,7,4,5,0,130,90,200,98,102
1400000US36081115700,Census Tract 1157,Queens, New York,109,329,94,235,2601,1156,1445,26,7,65,0,94,107,187,34,155
1400000US36081115900,Census Tract 1159,Queens, New York,109,353,176,177,3126,1450,1676,69,34,10,1041,152,144,181,62,117
1400000US36081116100,Census Tract 1161,Queens, New York,109,442,292,150,3823,1726,2097,146,96,61,688,185,407,440,249,193
1400000US36081116300,Census Tract 1163,Queens, New York,109,902,540,362,6484,3152,3332,196,117,86,1219,236,590,1206,649,556
1400000US36081116700,Census Tract 1167,Queens, New York,109,225,68,157,1365,686,679,26,8,12,183,111,117,143,67,76
1400000US36081117100,Census Tract 1171,Queens, New York,109,271,109,162,1974,901,1073,68,27,43,476,138,135,69,16,54
1400000US36081118500,Census Tract 1185,Queens, New York,109,254,132,122,1451,680,771,12,6,11,0,49,77,112,39,73
1400000US36081118700,Census Tract 1187,Queens, New York,109,263,98,165,1914,869,1045,11,4,18,0,121,246,201,82,119
1400000US36081118900,Census Tract 1189,Queens, New York,109,264,55,209,1986,826,1160,18,4,68,0,38,258,211,102,108
1400000US36081119100,Census Tract 1191,Queens, New York,109,421,217,204,2358,1162,1196,32,16,22,104,119,175,165,58,108
1400000US36081119300,Census Tract 1193,Queens, New York,109,229,204,25,1628,675,953,23,20,3,0,34,122,94,73,22
1400000US36081119500,Census Tract 1195,Queens, New York,109,108,48,60,1045,489,556,48,21,60,0,36,73,43,12,31
1400000US36081119900,Census Tract 1199,Queens, New York,109,128,47,81,1199,570,629,0,0,0,0,5,41,66,35,31
1400000US36081120100,Census Tract 1201,Queens, New York,109,187,66,121,1061,509,552,13,5,0,114,83,108,44,13,30
1400000US36081120300,Census Tract 1203,Queens, New York,109,71,32,39,1129,539,590,0,0,0,0,38,65,161,50,112
1400000US36081120500,Census Tract 1205,Queens, New York,109,71,50,21,1995,912,1083,1,1,0,0,204,263,154,46,108
1400000US36081120700,Census Tract 1207,Queens, New York,109,172,126,46,2339,1236,1103,15,11,5,0,187,92,201,104,98
1400000US36081121100,Census Tract 1211,Queens, New York,109,0,0,0,0,0,0,0,0,0,0,0,0,0,0,0
1400000US36081121500,Census Tract 1215,Queens, New York,109,454,241,213,2964,1525,1439,75,40,35,501,143,109,216,88,127
1400000US36081122701,Census Tract 1227.01,Queens, New York,109,792,286,506,7060,3256,3804,129,47,209,155,296,190,579,166,415
1400000US36081122702,Census Tract 1227.02,Queens, New York,109,589,434,155,4088,1672,2416,147,109,40,948,104,118,601,166,435
1400000US36081141700,Census Tract 1417,Queens, New York,109,422,229,193,3059,1436,1623,80,44,67,0,70,140,327,167,161
1400000US36081145900,Census Tract 1459,Queens, New York,109,159,149,10,2254,1040,1214,0,0,0,0,66,144,124,49,75
1400000US36081026700,Census Tract 267,Queens, New York,110,665,495,170,4006,2046,1960,321,239,93,1178,374,265,216,70,145
1400000US36081026901,Census Tract 269.01,Queens, New York,110,678,281,397,3741,2053,1688,271,112,179,1358,275,403,490,326,162
1400000US36081026902,Census Tract 269.02,Queens, New York,110,240,106,134,2822,1472,1350,40,18,49,20,140,193,302,113,188
1400000US36081027100,Census Tract 271,Queens, New York,110,1203,534,669,5001,2352,2649,561,249,454,1480,557,527,620,310,310
1400000US36081037500,Census Tract 375,Queens, New York,110,556,325,231,2406,1346,1060,184,108,102,426,596,303,334,188,146
1400000US36081038301,Census Tract 383.01,Queens, New York,110,0,0,0,0,0,0,0,0,0,0,0,0,0,0,0
1400000US36081039900,Census Tract 399,Queens, New York,110,539,380,159,2503,1384,1119,82,58,34,0,461,203,413,205,208
1400000US36081040100,Census Tract 401,Queens, New York,110,734,259,475,4751,2664,2087,295,104,281,1421,719,703,732,410,321
1400000US36081040300,Census Tract 403,Queens, New York,110,978,515,463,4515,2732,1783,450,237,214,2068,1011,481,470,287,182
1400000US36081040500,Census Tract 405,Queens, New York,110,407,253,154,2188,1210,978,159,99,77,468,456,429,230,129,100
1400000US36081040700,Census Tract 407,Queens, New York,110,1038,589,449,4432,2586,1846,437,248,150,2371,732,506,776,378,397
1400000US36081040900,Census Tract 409,Queens, New York,110,712,426,286,2903,1692,1211,298,178,97,1562,467,423,647,426,220
1400000US36081041100,Census Tract 411,Queens, New York,110,350,226,124,1875,964,911,93,60,21,816,292,351,234,165,69
1400000US36081041300,Census Tract 413,Queens, New York,110,421,206,215,2893,1619,1274,99,48,64,512,502,414,336,125,211
1400000US36081041500,Census Tract 415,Queens, New York,110,558,471,87,2522,1305,1217,85,72,11,666,495,406,368,120,247
1400000US36081042700,Census Tract 427,Queens, New York,110,438,218,220,2919,1509,1410,39,19,17,292,432,226,560,243,316
1400000US36081043701,Census Tract 437.01,Queens, New York,110,264,140,124,2406,1219,1187,136,72,71,1088,105,91,241,98,142
1400000US36081043702,Census Tract 437.02,Queens, New York,110,816,510,306,4213,2058,2155,304,190,89,2136,414,256,704,307,399
1400000US36081043900,Census Tract 439,Queens, New York,110,641,336,305,2460,1374,1086,153,80,62,686,416,299,241,132,110
1400000US36081044301,Census Tract 443.01,Queens, New York,110,581,268,313,2229,824,1405,181,84,96,704,233,306,132,48,83
1400000US36081044302,Census Tract 443.02,Queens, New York,110,488,295,193,2791,1308,1483,55,33,12,522,228,349,472,222,251
1400000US36081045500,Census Tract 455,Queens, New York,110,1264,705,559,8204,3523,4681,190,106,82,1280,292,215,943,444,496
1400000US36081045700,Census Tract 457,Queens, New York,110,395,297,98,2305,1149,1156,92,69,23,516,131,134,124,24,101
1400000US36081045900,Census Tract 459,Queens, New York,110,481,238,243,2920,1344,1576,26,13,26,0,185,279,625,384,241
1400000US36081046100,Census Tract 461,Queens, New York,110,342,125,217,1977,1080,897,62,23,57,265,324,203,202,60,141
1400000US36081046300,Census Tract 463,Queens, New York,110,318,143,175,2508,1293,1215,75,34,39,617,312,303,474,178,295
1400000US36081046500,Census Tract 465,Queens, New York,110,472,336,136,2433,1507,926,238,169,63,1467,475,347,363,289,72
1400000US36081046700,Census Tract 467,Queens, New York,110,709,417,292,4632,2564,2068,90,53,60,79,631,610,723,454,269
1400000US36081046900,Census Tract 469,Queens, New York,110,795,512,283,5652,2778,2874,214,138,111,260,375,529,656,281,376
1400000US36081047100,Census Tract 471,Queens, New York,110,342,207,135,2992,1452,1540,57,35,37,0,205,202,299,126,172
1400000US36081047300,Census Tract 473,Queens, New York,110,186,82,104,2712,1226,1486,12,5,0,312,120,204,393,186,207
1400000US36081047500,Census Tract 475,Queens, New York,110,408,131,277,3186,1636,1550,2,1,0,22,154,211,226,141,85
1400000US36081048100,Census Tract 481,Queens, New York,110,710,418,292,4468,2262,2206,198,117,89,1086,312,355,496,192,302
1400000US36081048300,Census Tract 483,Queens, New York,110,386,144,242,2706,1292,1414,45,17,42,225,147,189,411,190,221
1400000US36081049900,Census Tract 499,Queens, New York,110,392,279,113,3795,1822,1973,38,27,15,0,241,314,490,177,312
1400000US36081068300,Census Tract 683,Queens, New York,110,260,143,117,3300,1630,1670,45,25,27,340,236,361,195,90,107
1400000US36081068700,Census Tract 687,Queens, New York,110,194,46,148,3726,1743,1983,0,0,0,0,24,81,160,106,56
1400000US36081071702,Census Tract 717.02,Queens, New York,110,318,119,199,3057,1488,1569,39,15,0,599,42,28,107,39,69
1400000US36081099703,Census Tract 997.03,Queens, New York,111,585,158,427,3437,1584,1853,157,42,0,1265,0,11,278,135,143
1400000US36081109300,Census Tract 1093,Queens, New York,111,203,156,47,2329,1164,1165,0,0,0,0,49,106,133,49,84
1400000US36081109700,Census Tract 1097,Queens, New York,111,207,63,144,1379,692,687,34,10,59,77,23,24,39,32,6
1400000US36081109900,Census Tract 1099,Queens, New York,111,234,168,66,2342,1132,1210,12,9,5,0,53,83,157,58,100
1400000US36081111300,Census Tract 1113,Queens, New York,111,209,72,137,1932,873,1059,15,5,28,0,30,49,100,44,56
1400000US36081112300,Census Tract 1123,Queens, New York,111,124,60,64,1592,740,852,0,0,0,0,118,60,100,17,84
1400000US36081112900,Census Tract 1129,Queens, New York,111,209,73,136,1531,730,801,47,16,0,530,21,45,106,49,57
1400000US36081113300,Census Tract 1133,Queens, New York,111,117,69,48,1040,462,578,22,13,0,476,39,34,86,75,11
1400000US36081113900,Census Tract 1139,Queens, New York,111,308,144,164,2581,1275,1306,6,3,0,95,48,54,137,62,74
1400000US36081117500,Census Tract 1175,Queens, New York,111,519,126,393,3423,1533,1890,0,0,0,0,64,138,274,115,159
1400000US36081118100,Census Tract 1181,Queens, New York,111,210,81,129,1396,697,699,38,15,45,109,40,33,278,161,117
1400000US36081128300,Census Tract 1283,Queens, New York,111,14,0,14,38,13,25,0,0,0,0,0,0,0,0,0
1400000US36081129102,Census Tract 1291.02,Queens, New York,111,240,110,130,2263,1021,1242,24,11,8,296,31,21,75,40,34
1400000US36081129103,Census Tract 1291.03,Queens, New York,111,172,82,90,2842,1386,1456,0,0,0,0,18,33,82,47,33
1400000US36081129104,Census Tract 1291.04,Queens, New York,111,324,131,193,3155,1234,1921,41,17,0,669,52,36,110,26,83
1400000US36081130100,Census Tract 1301,Queens, New York,111,368,197,171,2794,1387,1407,5,3,0,81,55,13,117,58,61
1400000US36081134700,Census Tract 1347,Queens, New York,111,759,246,513,6662,3074,3588,12,4,0,153,40,43,266,92,176
1400000US36081136700,Census Tract 1367,Queens, New York,111,215,96,119,4417,2103,2314,0,0,0,0,25,90,133,61,72
1400000US36081137700,Census Tract 1377,Queens, New York,111,545,250,295,4650,2212,2438,64,29,59,219,104,168,144,95,49
1400000US36081138501,Census Tract 1385.01,Queens, New York,111,324,210,114,3082,1458,1624,17,11,9,0,77,102,102,52,49
1400000US36081139900,Census Tract 1399,Queens, New York,111,107,33,74,1289,575,714,6,2,0,104,70,69,36,11,25
1400000US36081140300,Census Tract 1403,Queens, New York,111,207,85,122,1860,841,1019,10,4,0,153,32,39,208,98,111
1400000US36081140901,Census Tract 1409.01,Queens, New York,111,50,38,12,649,313,336,23,17,4,595,23,26,25,6,19
1400000US36081140902,Census Tract 1409.02,Queens, New York,111,154,73,81,1795,872,923,11,5,0,244,67,95,111,85,26
1400000US36081142900,Census Tract 1429,Queens, New York,111,222,133,89,2381,1129,1252,10,6,1,240,95,88,93,26,68
1400000US36081143500,Census Tract 1435,Queens, New York,111,151,56,95,1732,817,915,2,1,3,0,66,76,144,126,17
1400000US36081144100,Census Tract 1441,Queens, New York,111,184,99,85,2299,1093,1206,0,0,0,0,95,101,113,49,63
1400000US36081144700,Census Tract 1447,Queens, New York,111,410,228,182,1910,900,1010,152,85,92,388,64,142,159,72,86
1400000US36081145101,Census Tract 1451.01,Queens, New York,111,178,66,112,1061,529,532,1,0,2,0,25,3,92,30,62
1400000US36081145102,Census Tract 1451.02,Queens, New York,111,206,117,89,1826,903,923,38,22,29,0,29,65,245,136,108
1400000US36081146300,Census Tract 1463,Queens, New York,111,255,133,122,2199,866,1333,48,25,28,306,94,147,209,32,177
1400000US36081146700,Census Tract 1467,Queens, New York,111,222,128,94,2421,1138,1283,0,0,0,0,41,101,99,42,58
1400000US36081147100,Census Tract 1471,Queens, New York,111,291,146,145,2334,969,1365,0,0,0,0,66,57,65,8,57
1400000US36081147900,Census Tract 1479,Queens, New York,111,391,167,224,2828,1489,1339,34,15,46,0,98,12,28,16,11
1400000US36081148300,Census Tract 1483,Queens, New York,111,241,152,89,2224,1092,1132,0,0,0,0,12,9,53,29,24
1400000US36081150701,Census Tract 1507.01,Queens, New York,111,169,81,88,2084,1007,1077,3,1,0,71,31,39,31,14,17
1400000US36081150702,Census Tract 1507.02,Queens, New York,111,219,87,132,2235,1011,1224,51,20,77,0,36,86,78,43,35
1400000US36081064500,Census Tract 645,Queens, New York,112,78,32,46,1491,733,758,0,0,0,0,11,32,116,46,70
1400000US36081069300,Census Tract 693,Queens, New York,112,196,151,45,1954,923,1031,10,8,3,0,0,57,131,56,75
1400000US36081069500,Census Tract 695,Queens, New York,112,243,101,142,1688,735,953,0,0,0,0,13,7,155,87,69
1400000US36081069701,Census Tract 697.01,Queens, New York,112,232,122,110,2603,1327,1276,15,8,14,0,20,71,156,62,93
1400000US36081069702,Census Tract 697.02,Queens, New York,112,352,176,176,2940,1330,1610,0,0,0,0,120,100,168,41,127
1400000US36081070300,Census Tract 703,Queens, New York,112,34,0,34,1478,669,809,0,0,0,0,17,37,69,54,16
1400000US36081070700,Census Tract 707,Queens, New York,112,266,131,135,2055,946,1109,0,0,0,0,58,120,90,67,23
1400000US36081070900,Census Tract 709,Queens, New York,112,181,134,47,1804,803,1001,0,0,0,0,4,20,63,17,47
1400000US36081071100,Census Tract 711,Queens, New York,112,324,109,215,4480,2034,2446,37,12,73,0,69,98,139,98,42
1400000US36081071303,Census Tract 713.03,Queens, New York,112,152,60,92,3921,1720,2201,8,3,0,341,169,0,192,83,110
1400000US36081071304,Census Tract 713.04,Queens, New York,112,288,223,65,4776,2270,2506,13,10,0,955,45,70,153,79,75
1400000US36081071305,Census Tract 713.05,Queens, New York,112,196,97,99,3634,1709,1925,0,0,0,0,27,48,131,48,85
1400000US36081071306,Census Tract 713.06,Queens, New York,112,505,214,291,4498,1963,2535,116,49,124,387,2,147,99,49,51
1400000US36081071701,Census Tract 717.01,Queens, New York,112,206,117,89,4177,1871,2306,1,1,1,0,28,173,129,99,30
1400000US36081071900,Census Tract 719,Queens, New York,112,229,148,81,1760,825,935,44,28,24,0,27,102,192,88,103
1400000US36081072100,Census Tract 721,Queens, New York,112,321,93,228,3764,1751,2013,29,8,42,199,39,62,132,53,81
1400000US36081072300,Census Tract 723,Queens, New York,112,146,90,56,1715,758,957,21,13,0,643,15,14,21,0,21
1400000US36081072900,Census Tract 729,Queens, New York,112,84,49,35,858,418,440,11,6,0,269,14,0,67,18,49
1400000US36081073100,Census Tract 731,Queens, New York,112,189,77,112,1024,518,506,11,4,0,100,20,25,7,7,0
1400000US36081073700,Census Tract 737,Queens, New York,112,26,7,19,1642,764,878,18,5,19,951,30,9,5,0,5
1400000US36081073900,Census Tract 739,Queens, New York,112,218,124,94,4267,1754,2513,0,0,0,0,40,93,94,46,50
1400000US36081074100,Census Tract 741,Queens, New York,112,205,95,110,2239,986,1253,39,18,0,795,25,36,63,19,43
1400000US36081074300,Census Tract 743,Queens, New York,112,342,150,192,3062,1466,1596,9,4,12,0,84,99,116,18,99
1400000US36081074500,Census Tract 745,Queens, New York,112,228,78,150,2849,1260,1589,8,3,0,151,59,114,236,103,133
1400000US36081074700,Census Tract 747,Queens, New York,112,331,152,179,2383,1136,1247,0,0,0,0,127,102,69,41,29
1400000US36081075701,Census Tract 757.01,Queens, New York,112,159,63,96,3793,1768,2025,0,0,0,0,0,0,27,14,12
1400000US36081075702,Census Tract 757.02,Queens, New York,112,128,112,16,3886,1617,2269,29,25,4,0,13,132,210,60,152
1400000US36081018200,Census Tract 182,Queens, New York,113,188,94,94,1398,630,768,37,19,9,417,129,79,164,124,39
1400000US36081018401,Census Tract 184.01,Queens, New York,113,126,54,72,1507,752,755,54,23,29,669,13,30,425,211,214
1400000US36081018402,Census Tract 184.02,Queens, New York,113,179,101,78,1475,753,722,79,45,56,133,28,51,112,57,55
1400000US36081018600,Census Tract 186,Queens, New York,113,300,109,191,913,332,581,40,14,23,129,43,35,80,36,44
1400000US36081018800,Census Tract 188,Queens, New York,113,120,33,87,719,348,371,0,0,0,0,40,13,76,42,34
1400000US36081019000,Census Tract 190,Queens, New York,113,182,68,114,1248,653,595,33,12,37,120,32,39,109,46,62
1400000US36081019200,Census Tract 192,Queens, New York,113,171,126,45,1298,601,697,86,63,25,432,56,175,67,22,46
1400000US36081019400,Census Tract 194,Queens, New York,113,296,241,55,1478,757,721,133,108,30,0,52,61,95,29,66
1400000US36081019600,Census Tract 196,Queens, New York,113,214,119,95,1425,587,838,16,9,6,120,68,35,177,117,59
1400000US36081026200,Census Tract 262,Queens, New York,113,218,143,75,772,349,423,47,31,25,0,45,8,67,44,23
1400000US36081026400,Census Tract 264,Queens, New York,113,119,87,32,1387,520,867,24,18,9,0,25,67,225,134,91
1400000US36081026600,Census Tract 266,Queens, New York,113,178,123,55,1142,414,728,53,37,24,0,43,117,293,126,167
1400000US36081027000,Census Tract 270,Queens, New York,113,161,110,51,1048,493,555,18,12,4,205,46,69,147,58,89
1400000US36081027200,Census Tract 272,Queens, New York,113,176,126,50,1408,600,808,32,23,13,0,53,34,211,97,114
1400000US36081027400,Census Tract 274,Queens, New York,113,176,69,107,1485,760,725,32,13,16,306,14,65,200,117,83
1400000US36081027600,Census Tract 276,Queens, New York,113,129,72,57,672,261,411,40,22,21,165,18,51,113,54,59
1400000US36081027800,Census Tract 278,Queens, New York,113,310,151,159,1420,447,973,140,68,96,437,16,38,233,110,123
1400000US36081028000,Census Tract 280,Queens, New York,113,81,5,76,1012,443,569,5,0,76,0,18,37,137,78,59
1400000US36081028200,Census Tract 282,Queens, New York,113,83,20,63,1064,355,709,0,0,0,0,0,23,152,76,76
1400000US36081028400,Census Tract 284,Queens, New York,113,478,273,205,2018,736,1282,62,35,26,266,37,91,184,60,124
1400000US36081028800,Census Tract 288,Queens, New York,113,521,221,300,2739,1262,1477,162,69,119,677,74,93,356,167,188
1400000US36081029400,Census Tract 294,Queens, New York,113,674,358,316,4213,1900,2313,132,70,51,986,125,194,236,181,53
1400000US36081032800,Census Tract 328,Queens, New York,113,215,67,148,1746,698,1048,64,20,102,213,56,77,278,152,126
1400000US36081033000,Census Tract 330,Queens, New York,113,950,522,428,4526,1872,2654,133,73,55,697,232,345,539,309,231
1400000US36081033401,Census Tract 334.01,Queens, New York,113,329,141,188,1881,799,1082,0,0,0,0,9,29,164,111,53
1400000US36081033402,Census Tract 334.02,Queens, New York,113,963,360,603,9212,3238,5974,220,82,186,1667,117,341,829,272,556
1400000US36081035200,Census Tract 352,Queens, New York,113,165,98,67,1766,736,1030,14,8,10,0,27,61,109,67,43
1400000US36081036600,Census Tract 366,Queens, New York,113,192,69,123,1667,786,881,15,5,27,0,106,30,233,160,73
1400000US36081036800,Census Tract 368,Queens, New York,113,173,93,80,1600,736,864,9,5,8,0,35,75,69,42,27
1400000US36081038400,Census Tract 384,Queens, New York,113,306,145,161,1645,738,907,29,14,0,296,18,26,117,72,45
1400000US36081039400,Census Tract 394,Queens, New York,113,284,149,135,1910,679,1231,25,13,0,353,45,37,222,159,62
1400000US36081039800,Census Tract 398,Queens, New York,113,204,64,140,1453,610,843,8,2,18,0,51,10,212,132,80
1400000US36081040000,Census Tract 400,Queens, New York,113,60,38,22,829,335,494,20,13,12,0,11,30,95,57,38
1400000US36081040200,Census Tract 402,Queens, New York,113,223,143,80,859,342,517,41,26,23,0,0,48,43,37,6
1400000US36081040400,Census Tract 404,Queens, New York,113,560,170,390,2615,1134,1481,110,33,138,335,179,111,256,75,181
1400000US36081042400,Census Tract 424,Queens, New York,113,326,169,157,1707,729,978,29,15,12,174,62,47,55,10,45
1400000US36081042600,Census Tract 426,Queens, New York,113,11,0,11,472,379,93,0,0,0,0,39,34,105,105,0
1400000US36081043200,Census Tract 432,Queens, New York,113,168,126,42,934,431,503,12,9,4,0,12,1,92,43,49
1400000US36081043400,Census Tract 434,Queens, New York,113,189,45,144,926,325,601,27,6,0,174,0,32,9,0,9
1400000US36081050400,Census Tract 504,Queens, New York,113,219,176,43,1111,470,641,0,0,0,0,8,23,50,29,21
1400000US36081050600,Census Tract 506,Queens, New York,113,294,232,62,1066,464,602,96,76,21,309,23,28,99,71,28
1400000US36081050800,Census Tract 508,Queens, New York,113,139,65,74,1175,505,670,0,0,0,0,18,73,94,43,51
1400000US36081051000,Census Tract 510,Queens, New York,113,150,102,48,1068,491,577,10,7,5,0,22,40,124,54,70
1400000US36081051800,Census Tract 518,Queens, New York,113,311,164,147,1204,414,790,75,40,60,65,15,24,107,61,46
1400000US36081052000,Census Tract 520,Queens, New York,113,189,106,83,1269,475,794,0,0,0,0,13,21,79,18,61
1400000US36081052200,Census Tract 522,Queens, New York,113,313,221,92,1319,534,785,40,28,17,0,21,34,107,46,61
1400000US36081052400,Census Tract 524,Queens, New York,113,135,65,70,1266,534,732,10,5,0,181,43,80,94,59,35
1400000US36081052600,Census Tract 526,Queens, New York,113,207,134,73,1230,549,681,38,25,20,33,43,106,133,20,113
1400000US36081052800,Census Tract 528,Queens, New York,113,93,50,43,790,315,475,0,0,0,0,39,0,91,51,40
1400000US36081053000,Census Tract 530,Queens, New York,113,149,78,71,1621,705,916,32,17,29,0,52,38,165,79,86
1400000US36081053200,Census Tract 532,Queens, New York,113,69,36,33,891,337,554,18,9,0,486,29,0,40,7,33
1400000US36081066400,Census Tract 664,Queens, New York,113,1083,516,567,6371,2514,3857,192,91,83,1306,191,193,414,209,208
1400000US36081078800,Census Tract 788,Queens, New York,113,167,31,136,976,460,516,0,0,0,0,15,27,69,31,38
1400000US36081079000,Census Tract 790,Queens, New York,113,191,37,154,1489,689,800,35,7,0,338,86,88,220,111,109
1400000US36081107202,Census Tract 1072.02,Queens, New York,113,0,0,0,0,0,0,0,0,0,0,0,0,0,0,0
1400000US36081003100,Census Tract 31,Queens, New York,114,160,75,85,821,430,391,15,7,17,0,35,15,55,32,23
1400000US36081003300,Census Tract 33,Queens, New York,114,476,314,162,1265,584,681,40,26,7,202,32,40,201,105,96
1400000US36081003900,Census Tract 39,Queens, New York,114,194,116,78,928,514,414,93,56,24,678,94,51,204,114,90
1400000US36081004300,Census Tract 43,Queens, New York,114,346,247,99,1325,396,929,37,26,15,0,45,120,197,73,125
1400000US36081004500,Census Tract 45,Queens, New York,114,94,63,31,2181,956,1225,0,0,0,0,59,34,144,45,98
1400000US36081004700,Census Tract 47,Queens, New York,114,533,324,209,2756,1160,1596,206,125,109,488,167,337,529,247,281
1400000US36081005100,Census Tract 51,Queens, New York,114,196,93,103,1222,550,672,13,6,14,0,57,155,156,50,106
1400000US36081005300,Census Tract 53,Queens, New York,114,344,110,234,4094,2023,2071,0,0,0,0,69,79,282,103,180
1400000US36081005500,Census Tract 55,Queens, New York,114,76,0,76,760,402,358,0,0,0,0,128,96,101,76,25
1400000US36081005700,Census Tract 57,Queens, New York,114,322,160,162,2956,1333,1623,38,19,28,183,124,206,183,115,70
1400000US36081005900,Census Tract 59,Queens, New York,114,431,174,257,2834,1293,1541,17,7,13,88,85,133,255,131,126
1400000US36081006100,Census Tract 61,Queens, New York,114,693,295,398,4428,2088,2340,84,36,113,0,198,176,226,194,30
1400000US36081006300,Census Tract 63,Queens, New York,114,620,375,245,3939,2265,1674,32,20,13,193,165,94,197,97,100
1400000US36081006501,Census Tract 65.01,Queens, New York,114,314,98,216,2780,1470,1310,26,8,57,0,87,157,75,43,34
1400000US36081006502,Census Tract 65.02,Queens, New York,114,435,132,303,2907,1529,1378,62,19,0,596,223,265,209,109,99
1400000US36081006900,Census Tract 69,Queens, New York,114,523,316,207,3359,1912,1447,56,34,37,0,241,352,333,161,169
1400000US36081007100,Census Tract 71,Queens, New York,114,359,189,170,2768,1455,1313,39,21,35,0,164,194,111,65,47
1400000US36081007300,Census Tract 73,Queens, New York,114,426,118,308,3124,1591,1533,52,14,0,528,113,71,256,95,159
1400000US36081007500,Census Tract 75,Queens, New York,114,273,130,143,2915,1421,1494,0,0,0,0,173,290,271,179,91
1400000US36081007700,Census Tract 77,Queens, New York,114,115,107,8,1023,529,494,19,18,1,0,34,54,37,8,29
1400000US36081007900,Census Tract 79,Queens, New York,114,354,238,116,2223,1187,1036,157,106,65,460,193,188,289,150,139
1400000US36081008100,Census Tract 81,Queens, New York,114,132,72,60,567,327,240,68,37,31,293,71,26,34,8,26
1400000US36081008300,Census Tract 83,Queens, New York,114,438,299,139,2326,1121,1205,84,57,10,1037,200,171,270,99,171
1400000US36081008500,Census Tract 85,Queens, New York,114,66,16,50,607,381,226,22,5,34,134,31,28,93,45,48
1400000US36081008700,Census Tract 87,Queens, New York,114,643,355,288,2167,738,1429,129,71,74,286,63,269,388,109,279
1400000US36081009100,Census Tract 91,Queens, New York,114,384,219,165,1870,969,901,25,14,19,0,114,82,69,0,69
1400000US36081009500,Census Tract 95,Queens, New York,114,276,113,163,2154,1127,1027,23,9,33,0,39,76,90,9,81
1400000US36081009700,Census Tract 97,Queens, New York,114,417,196,221,2847,1511,1336,66,31,42,373,261,150,151,73,79
1400000US36081009900,Census Tract 99,Queens, New York,114,0,0,0,0,0,0,0,0,0,0,0,0,0,0,0
1400000US36081010100,Census Tract 101,Queens, New York,114,190,51,139,1846,967,879,0,0,0,0,85,135,109,35,74
1400000US36081010300,Census Tract 103,Queens, New York,114,150,16,134,3134,1574,1560,16,2,0,373,72,137,232,165,69
1400000US36081010500,Census Tract 105,Queens, New York,114,403,271,132,3041,1447,1594,29,20,11,161,239,269,307,132,175
1400000US36081010701,Census Tract 107.01,Queens, New York,114,0,0,0,0,0,0,0,0,0,0,0,0,0,0,0
1400000US36081011100,Census Tract 111,Queens, New York,114,163,73,90,2315,1151,1164,6,3,7,0,55,52,162,48,115
1400000US36081011300,Census Tract 113,Queens, New York,114,622,239,383,3710,1792,1918,89,34,58,512,202,194,189,111,81
1400000US36081011500,Census Tract 115,Queens, New York,114,333,168,165,2059,1047,1012,63,32,46,200,122,110,165,97,67
1400000US36081011700,Census Tract 117,Queens, New York,114,362,112,250,2854,1394,1460,7,2,16,0,84,66,111,93,18
1400000US36081011900,Census Tract 119,Queens, New York,114,212,67,145,1365,666,699,34,11,30,188,44,69,153,66,87
1400000US36081012100,Census Tract 121,Queens, New York,114,78,31,47,1858,803,1055,0,0,0,0,63,118,141,64,78
1400000US36081012301,Census Tract 123.01,Queens, New York,114,248,157,91,2240,1039,1201,29,18,0,715,119,120,74,27,47
1400000US36081012500,Census Tract 125,Queens, New York,114,127,40,87,1634,745,889,6,2,0,113,138,118,44,22,22
1400000US36081013500,Census Tract 135,Queens, New York,114,57,42,15,1318,612,706,0,0,0,0,65,133,109,62,48
1400000US36081013700,Census Tract 137,Queens, New York,114,53,25,28,1128,524,604,0,0,0,0,53,67,19,6,13
1400000US36081014100,Census Tract 141,Queens, New York,114,230,117,113,1205,657,548,31,16,11,213,40,68,93,52,41
1400000US36081014300,Census Tract 143,Queens, New York,114,341,221,120,3008,1490,1518,76,49,41,0,136,231,193,115,77
1400000US36081014500,Census Tract 145,Queens, New York,114,136,42,94,1629,761,868,0,0,0,0,40,47,60,38,23
1400000US36081014700,Census Tract 147,Queens, New York,114,109,28,81,2248,1157,1091,0,0,0,0,105,120,88,38,50
1400000US36081014900,Census Tract 149,Queens, New York,114,261,39,222,1644,779,865,13,2,0,97,62,142,181,89,92
1400000US36081015100,Census Tract 151,Queens, New York,114,458,204,254,2211,1125,1086,0,0,0,0,149,85,230,63,168
1400000US36081015300,Census Tract 153,Queens, New York,114,163,106,57,1615,878,737,1,1,1,0,100,76,129,50,80
1400000US36081015500,Census Tract 155,Queens, New York,114,160,48,112,1737,864,873,19,6,21,155,91,136,94,48,45
1400000US36081015700,Census Tract 157,Queens, New York,114,108,76,32,1191,732,459,4,3,2,0,84,28,131,57,74
1400000US36081015900,Census Tract 159,Queens, New York,114,692,407,285,2943,1478,1465,26,15,18,0,171,129,274,157,117
1400000US36081016100,Census Tract 161,Queens, New York,114,121,73,48,1792,765,1027,33,20,22,0,159,112,109,74,35
1400000US36081016300,Census Tract 163,Queens, New York,114,471,275,196,2680,971,1709,89,52,24,753,136,174,367,141,227
1400000US36081029500,Census Tract 295,Queens, New York,114,351,128,223,2762,1305,1457,16,6,12,110,131,112,251,61,189
1400000US36081029900,Census Tract 299,Queens, New York,114,0,0,0,0,0,0,0,0,0,0,0,0,0,0,0
1400000US36081030902,Census Tract 309.02,Queens, New York,114,786,455,331,5913,3118,2795,156,90,79,840,430,551,639,449,187
1400000US36081030904,Census Tract 309.04,Queens, New York,114,479,165,314,2656,1427,1229,169,58,112,930,131,93,268,131,138
1400000US36005000100,Census Tract 1,Bronx, New York,114,3003,2752,251,6819,6041,778,2417,2215,201,5708,550,50,4337,3812,528
1400000US36061023801,Census Tract 238.01,Manhattan, New York,114,718,295,423,6333,2797,3536,87,36,76,507,50,106,247,151,95
1400000US36061023802,Census Tract 238.02,Manhattan, New York,114,67,17,50,2309,1352,957,17,4,24,416,260,214,353,219,134
1400000US36081026500,Census Tract 265,Queens, New York,115,242,132,110,3022,1560,1462,31,17,0,852,122,270,644,289,355
1400000US36081027300,Census Tract 273,Queens, New York,115,854,443,411,5192,2717,2475,375,194,231,1594,696,458,851,527,324
1400000US36081027500,Census Tract 275,Queens, New York,115,810,330,480,4319,2192,2127,167,68,158,523,368,479,700,596,100
1400000US36081027700,Census Tract 277,Queens, New York,115,625,516,109,6063,3106,2957,187,154,39,0,770,970,497,351,145
1400000US36081027900,Census Tract 279,Queens, New York,115,411,148,263,4627,2143,2484,74,27,39,916,208,407,569,285,283
1400000US36081028100,Census Tract 281,Queens, New York,115,420,279,141,4261,1967,2294,147,98,74,0,122,174,567,260,307
1400000US36081028300,Census Tract 283,Queens, New York,115,372,197,175,5227,2571,2656,113,60,74,894,260,268,319,193,122
1400000US36081028500,Census Tract 285,Queens, New York,115,362,249,113,3615,1815,1800,140,96,43,1471,53,259,119,38,81
1400000US36081028700,Census Tract 287,Queens, New York,115,500,247,253,4626,2421,2205,72,36,31,768,218,117,412,223,187
1400000US36081028900,Census Tract 289,Queens, New York,115,504,175,329,3941,2058,1883,53,18,62,240,31,188,248,86,160
1400000US36081029700,Census Tract 297,Queens, New York,115,173,130,43,1370,619,751,0,0,0,0,30,58,82,33,49
1400000US36081030903,Census Tract 309.03,Queens, New York,115,666,492,174,3931,1989,1942,254,187,60,1922,213,439,629,380,251
1400000US36081031700,Census Tract 317,Queens, New York,115,587,298,289,4113,1825,2288,0,0,0,0,89,199,222,110,112
1400000US36081032700,Census Tract 327,Queens, New York,115,584,287,297,2501,1368,1133,149,73,105,405,222,242,245,131,114
1400000US36081032900,Census Tract 329,Queens, New York,115,599,282,317,3305,1656,1649,63,30,42,271,171,148,337,157,178
1400000US36081033100,Census Tract 331,Queens, New York,115,0,0,0,0,0,0,0,0,0,0,0,0,0,0,0
1400000US36081033700,Census Tract 337,Queens, New York,115,561,298,263,2198,1189,1009,163,87,107,352,214,126,200,93,106
1400000US36081033900,Census Tract 339,Queens, New York,115,432,321,111,2448,1080,1368,90,67,28,220,185,157,154,76,79
1400000US36081034700,Census Tract 347,Queens, New York,115,413,222,191,2211,1010,1201,20,11,1,219,105,101,254,60,195
1400000US36081035100,Census Tract 351,Queens, New York,115,537,338,199,2760,1389,1371,99,62,39,444,226,206,284,117,169
1400000US36081035300,Census Tract 353,Queens, New York,115,187,171,16,1678,849,829,17,16,2,0,238,102,201,153,48
1400000US36081035700,Census Tract 357,Queens, New York,115,468,198,270,3294,1522,1772,152,64,22,1660,120,193,501,212,289
1400000US36081036100,Census Tract 361,Queens, New York,115,247,128,119,1403,729,674,90,47,43,519,108,119,95,60,35
1400000US36081036300,Census Tract 363,Queens, New York,115,169,120,49,1849,1030,819,55,39,22,0,275,299,135,87,48
1400000US36081036500,Census Tract 365,Queens, New York,115,446,275,171,2504,1476,1028,69,43,26,396,378,327,398,260,139
1400000US36081036700,Census Tract 367,Queens, New York,115,462,277,185,1586,692,894,87,52,54,51,55,151,147,96,52
1400000US36081037100,Census Tract 371,Queens, New York,115,179,80,99,1184,475,709,42,19,26,251,90,97,134,55,79
1400000US36081037300,Census Tract 373,Queens, New York,115,357,222,135,1710,848,862,70,44,10,672,254,106,245,112,132
1400000US36081037700,Census Tract 377,Queens, New York,115,478,295,183,1848,938,910,171,106,46,979,196,157,242,102,141
1400000US36081037900,Census Tract 379,Queens, New York,115,859,532,327,3834,2441,1393,217,135,88,866,542,536,556,437,117
1400000US36081038100,Census Tract 381,Queens, New York,115,850,591,259,3410,1886,1524,384,267,133,1054,526,357,402,179,223
1400000US36085000300,Census Tract 3,Staten Island, New York,120,190,64,126,1236,561,675,33,11,10,274,27,7,133,27,106
1400000US36085000600,Census Tract 6,Staten Island, New York,120,157,66,91,1801,825,976,5,2,0,99,24,50,238,111,127
1400000US36085000700,Census Tract 7,Staten Island, New York,120,289,226,63,3358,1578,1780,73,57,20,0,115,189,410,170,237
1400000US36085000800,Census Tract 8,Staten Island, New York,120,518,224,294,3904,2001,1903,43,19,49,78,164,162,246,128,118
1400000US36085000900,Census Tract 9,Staten Island, New York,120,288,108,180,1271,744,527,12,5,0,85,10,12,159,111,48
1400000US36085001100,Census Tract 11,Staten Island, New York,120,542,241,301,1917,837,1080,305,136,162,1114,109,106,234,78,156
1400000US36085001700,Census Tract 17,Staten Island, New York,120,157,62,95,894,542,352,53,21,32,301,104,55,33,19,14
1400000US36085002100,Census Tract 21,Staten Island, New York,120,377,252,125,2287,1162,1125,68,45,33,18,205,155,236,148,87
1400000US36085002700,Census Tract 27,Staten Island, New York,120,302,192,110,1434,668,766,41,26,13,248,111,87,162,67,95
1400000US36085002900,Census Tract 29,Staten Island, New York,120,623,412,211,3201,1432,1769,215,142,89,621,163,159,627,318,310
1400000US36085003300,Census Tract 33,Staten Island, New York,120,254,113,141,2334,996,1338,0,0,0,0,36,52,177,58,119
1400000US36085003900,Census Tract 39,Staten Island, New York,120,768,363,405,1499,705,794,0,0,0,0,29,27,64,25,39
1400000US36085004000,Census Tract 40,Staten Island, New York,120,1560,655,905,7880,3445,4435,448,188,449,1064,486,816,993,448,541
1400000US36085005900,Census Tract 59,Staten Island, New York,120,232,107,125,1798,831,967,27,12,0,388,13,0,65,35,29
1400000US36085006700,Census Tract 67,Staten Island, New York,120,267,143,124,1934,959,975,16,9,14,0,2,0,73,45,29
1400000US36085007500,Census Tract 75,Staten Island, New York,120,400,264,136,2784,1356,1428,162,107,67,635,71,216,245,148,99
1400000US36085007700,Census Tract 77,Staten Island, New York,120,267,107,160,706,289,417,52,21,55,66,15,0,86,64,22
1400000US36085008100,Census Tract 81,Staten Island, New York,120,305,95,210,2864,1262,1602,59,18,20,682,58,208,295,177,117
1400000US36085009700,Census Tract 97,Staten Island, New York,120,319,126,193,2011,934,1077,51,20,78,0,25,11,111,18,92
1400000US36085010500,Census Tract 105,Staten Island, New York,120,463,220,243,3282,1552,1730,118,56,42,1080,123,78,318,146,171
1400000US36085012100,Census Tract 121,Staten Island, New York,120,249,124,125,2078,940,1138,15,7,0,249,20,33,79,23,57
1400000US36085012500,Census Tract 125,Staten Island, New York,120,222,55,167,1699,828,871,22,5,67,0,2,10,150,90,60
1400000US36085013301,Census Tract 133.01,Staten Island, New York,120,239,158,81,799,202,597,94,62,43,109,25,29,179,11,168
1400000US36085013302,Census Tract 133.02,Staten Island, New York,120,394,312,82,2045,1043,1002,42,33,5,524,102,120,215,108,106
1400000US36085014100,Census Tract 141,Staten Island, New York,120,211,147,64,1863,849,1014,8,6,0,233,88,100,76,33,44
1400000US36085014700,Census Tract 147,Staten Island, New York,120,165,86,79,2307,1018,1289,0,0,0,0,4,12,106,19,86
1400000US36085015100,Census Tract 151,Staten Island, New York,120,465,279,186,3778,1665,2113,111,67,74,0,87,42,196,55,139
1400000US36085018701,Census Tract 187.01,Staten Island, New York,121,89,40,49,1270,606,664,8,4,7,52,0,22,105,57,48
1400000US36085018702,Census Tract 187.02,Staten Island, New York,121,553,317,236,5405,2460,2945,43,25,32,0,185,321,313,32,283
1400000US36085018901,Census Tract 189.01,Staten Island, New York,121,372,188,184,3747,1793,1954,15,8,15,0,70,106,360,134,227
1400000US36085018902,Census Tract 189.02,Staten Island, New York,121,365,147,218,3662,1804,1858,46,19,68,0,32,20,249,110,139
1400000US36085019700,Census Tract 197,Staten Island, New York,121,170,90,80,1213,544,669,9,5,8,0,3,20,22,6,16
1400000US36085020100,Census Tract 201,Staten Island, New York,121,250,151,99,2431,1235,1196,38,23,11,515,23,45,124,56,67
1400000US36085020700,Census Tract 207,Staten Island, New York,121,568,283,285,3021,1391,1630,172,86,70,1082,218,139,568,284,284
1400000US36085021300,Census Tract 213,Staten Island, New York,121,841,383,458,3193,1651,1542,237,108,145,808,135,116,386,165,221
1400000US36085022300,Census Tract 223,Staten Island, New York,121,259,100,159,1755,818,937,81,31,51,541,41,75,139,48,91
1400000US36085023100,Census Tract 231,Staten Island, New York,121,585,215,370,3013,1512,1501,184,68,141,832,172,182,440,333,107
1400000US36085023900,Census Tract 239,Staten Island, New York,121,262,180,82,2024,932,1092,90,62,29,642,34,75,184,52,132
1400000US36085024700,Census Tract 247,Staten Island, New York,121,148,62,86,1669,850,819,26,11,12,330,35,129,165,123,43
1400000US36085025100,Census Tract 251,Staten Island, New York,121,289,130,159,4078,1944,2134,0,0,0,0,117,0,204,91,113
1400000US36085027301,Census Tract 273.01,Staten Island, New York,121,187,117,70,2813,1400,1413,0,0,0,0,88,54,253,176,76
1400000US36085027302,Census Tract 273.02,Staten Island, New York,121,290,143,147,2841,1402,1439,40,20,10,580,35,10,134,79,55
1400000US36085027702,Census Tract 277.02,Staten Island, New York,121,441,202,239,4409,1931,2478,40,18,0,736,50,77,203,71,134
1400000US36085027704,Census Tract 277.04,Staten Island, New York,121,393,227,166,3181,1621,1560,4,2,3,0,66,36,369,217,151
1400000US36085027705,Census Tract 277.05,Staten Island, New York,121,545,293,252,3845,1872,1973,20,11,10,138,64,75,219,148,71
1400000US36085027706,Census Tract 277.06,Staten Island, New York,121,440,285,155,2171,991,1180,33,21,18,0,46,92,310,138,173
1400000US36085027900,Census Tract 279,Staten Island, New York,121,163,49,114,1542,480,1062,0,0,0,0,25,82,150,28,122
1400000US36085029102,Census Tract 291.02,Staten Island, New York,121,124,87,37,1588,728,860,11,8,5,0,0,0,17,4,14
1400000US36085029103,Census Tract 291.03,Staten Island, New York,121,671,357,314,5441,2531,2910,75,40,29,729,46,102,239,73,163
1400000US36085029104,Census Tract 291.04,Staten Island, New York,121,470,205,265,4471,1994,2477,62,27,3,1010,80,196,219,94,124
1400000US36085030301,Census Tract 303.01,Staten Island, New York,121,489,327,162,3376,1537,1839,10,7,0,209,11,51,402,197,206
1400000US36085030302,Census Tract 303.02,Staten Island, New York,121,905,440,465,4117,1945,2172,204,99,84,1107,165,193,358,144,213
1400000US36085031901,Census Tract 319.01,Staten Island, New York,121,422,264,158,1705,553,1152,69,43,14,486,76,115,322,118,204
1400000US36085031902,Census Tract 319.02,Staten Island, New York,121,429,124,305,2534,1125,1409,42,12,66,124,90,49,193,131,62
1400000US36085032300,Census Tract 323,Staten Island, New York,121,279,160,119,697,266,431,18,10,0,105,15,6,136,41,95
1400000US36085001800,Census Tract 18,Staten Island, New York,122,220,155,65,527,275,252,0,0,0,0,0,18,39,9,30
1400000US36085002001,Census Tract 20.01,Staten Island, New York,122,244,136,108,1704,800,904,19,11,0,300,83,9,89,50,39
1400000US36085002002,Census Tract 20.02,Staten Island, New York,122,186,73,113,2340,1060,1280,22,9,34,0,70,99,161,73,90
1400000US36085003600,Census Tract 36,Staten Island, New York,122,279,195,84,1668,809,859,20,14,5,178,100,120,123,51,72
1400000US36085004700,Census Tract 47,Staten Island, New York,122,1588,627,961,1920,927,993,24,9,37,0,53,92,132,62,71
1400000US36085005000,Census Tract 50,Staten Island, New York,122,139,108,31,2514,1217,1297,16,12,5,0,88,47,126,46,80
1400000US36085006400,Census Tract 64,Staten Island, New York,122,273,100,173,2011,876,1135,45,17,22,372,73,110,286,150,135
1400000US36085007000,Census Tract 70,Staten Island, New York,122,743,391,352,5654,2936,2718,4,2,0,62,191,280,543,341,204
1400000US36085007400,Census Tract 74,Staten Island, New York,122,317,130,187,2963,1299,1664,42,17,29,350,122,165,370,69,301
1400000US36085009601,Census Tract 96.01,Staten Island, New York,122,284,150,134,2923,1281,1642,18,9,16,0,88,163,248,141,107
1400000US36085009602,Census Tract 96.02,Staten Island, New York,122,478,340,138,2220,968,1252,100,71,15,1015,97,58,120,19,101
1400000US36085011201,Census Tract 112.01,Staten Island, New York,122,461,228,233,4377,2190,2187,13,6,13,0,90,57,438,219,219
1400000US36085011202,Census Tract 112.02,Staten Island, New York,122,595,306,289,4150,2040,2110,40,21,20,274,84,61,291,126,162
1400000US36085011401,Census Tract 114.01,Staten Island, New York,122,201,102,99,2181,843,1338,3,2,0,65,22,41,229,81,149
1400000US36085011402,Census Tract 114.02,Staten Island, New York,122,260,122,138,2342,1055,1287,67,31,32,663,18,66,169,109,59
1400000US36085012200,Census Tract 122,Staten Island, New York,122,222,75,147,2557,1209,1348,34,11,16,453,8,54,136,48,88
1400000US36085012804,Census Tract 128.04,Staten Island, New York,122,426,205,221,2823,1326,1497,19,9,12,102,38,48,322,152,171
1400000US36085012805,Census Tract 128.05,Staten Island, New York,122,259,154,105,2317,1072,1245,0,0,0,0,35,68,211,146,63
1400000US36085012806,Census Tract 128.06,Staten Island, New York,122,497,207,290,4533,2136,2397,21,9,29,0,30,120,267,139,127
1400000US36085013201,Census Tract 132.01,Staten Island, New York,122,39,24,15,1140,577,563,0,0,0,0,16,16,38,31,7
1400000US36085013203,Census Tract 132.03,Staten Island, New York,122,371,185,186,3540,1604,1936,10,5,10,0,55,77,195,91,103
1400000US36085013204,Census Tract 132.04,Staten Island, New York,122,243,176,67,3632,1637,1995,58,42,15,1031,59,90,338,133,205
1400000US36085013400,Census Tract 134,Staten Island, New York,122,265,101,164,2885,1326,1559,1,0,0,17,72,62,162,85,76
1400000US36085013800,Census Tract 138,Staten Island, New York,122,373,99,274,4178,2005,2173,41,11,0,627,82,176,226,86,139
1400000US36085014604,Census Tract 146.04,Staten Island, New York,122,516,354,162,5318,2510,2808,41,28,6,920,15,67,378,228,146
1400000US36085014605,Census Tract 146.05,Staten Island, New York,122,253,108,145,2540,1232,1308,13,6,3,193,67,97,119,80,41
1400000US36085014606,Census Tract 146.06,Staten Island, New York,122,927,505,422,4839,2189,2650,100,55,52,436,57,29,237,142,95
1400000US36085014607,Census Tract 146.07,Staten Island, New York,122,261,143,118,3244,1462,1782,14,8,12,0,1,2,230,96,135
1400000US36085014608,Census Tract 146.08,Staten Island, New York,122,208,77,131,2461,1079,1382,0,0,0,0,0,39,69,23,47
1400000US36085015400,Census Tract 154,Staten Island, New York,122,0,0,0,0,0,0,0,0,0,0,0,0,0,0,0
1400000US36085015601,Census Tract 156.01,Staten Island, New York,122,680,322,358,4317,2000,2317,0,0,0,0,16,60,229,66,165
1400000US36085016901,Census Tract 169.01,Staten Island, New York,122,320,146,174,2299,1050,1249,25,11,30,0,54,59,154,106,47
1400000US36085017300,Census Tract 173,Staten Island, New York,122,248,160,88,1537,565,972,52,34,9,612,13,92,169,28,141
1400000US36085017700,Census Tract 177,Staten Island, New York,122,638,300,338,5235,2488,2747,62,29,51,262,107,184,199,114,82
1400000US36085018100,Census Tract 181,Staten Island, New York,122,182,125,57,2210,998,1212,62,43,24,349,23,102,157,45,112
1400000US36085015602,Census Tract 156.02,Staten Island, New York,123,158,72,86,2303,1080,1223,0,0,0,0,33,20,115,68,48
1400000US36085015603,Census Tract 156.03,Staten Island, New York,123,475,250,225,3192,1562,1630,9,5,8,0,22,18,131,55,77
1400000US36085017005,Census Tract 170.05,Staten Island, New York,123,513,218,295,2950,1400,1550,49,21,57,71,48,60,109,49,60
1400000US36085017007,Census Tract 170.07,Staten Island, New York,123,309,214,95,2923,1413,1510,37,26,8,552,57,76,175,71,104
1400000US36085017008,Census Tract 170.08,Staten Island, New York,123,733,320,413,5279,2625,2654,145,63,101,855,39,56,311,150,165
1400000US36085017009,Census Tract 170.09,Staten Island, New York,123,365,222,143,2840,1457,1383,19,12,12,0,45,54,219,163,57
1400000US36085017010,Census Tract 170.10,Staten Island, New York,123,984,499,485,5891,2873,3018,47,24,0,571,29,39,141,89,54
1400000US36085017011,Census Tract 170.11,Staten Island, New York,123,395,205,190,3452,1567,1885,0,0,0,0,14,11,338,94,247
1400000US36085017012,Census Tract 170.12,Staten Island, New York,123,275,206,69,3253,1590,1663,52,39,14,472,33,135,202,105,98
1400000US36085017600,Census Tract 176,Staten Island, New York,123,410,218,192,3313,1514,1799,0,0,0,0,45,23,116,42,74
1400000US36085019800,Census Tract 198,Staten Island, New York,123,797,465,332,4297,2053,2244,36,21,8,322,76,101,296,246,49
1400000US36085020801,Census Tract 208.01,Staten Island, New York,123,592,380,212,5631,2708,2923,25,16,0,664,154,82,287,144,143
1400000US36085020803,Census Tract 208.03,Staten Island, New York,123,427,242,185,4244,2024,2220,33,19,0,755,85,53,166,81,84
1400000US36085020804,Census Tract 208.04,Staten Island, New York,123,559,238,321,3649,1768,1881,0,0,0,0,42,47,99,41,58
1400000US36085022600,Census Tract 226,Staten Island, New York,123,834,549,285,5585,3245,2340,129,85,57,374,169,66,570,480,89
1400000US36085022800,Census Tract 228,Staten Island, New York,123,0,0,0,86,41,45,0,0,0,0,0,0,0,0,0
1400000US36085024401,Census Tract 244.01,Staten Island, New York,123,527,238,289,3790,1831,1959,0,0,0,0,29,0,220,137,80
1400000US36085024402,Census Tract 244.02,Staten Island, New York,123,347,230,117,2456,1228,1228,0,0,0,0,18,45,138,91,45
1400000US36085024800,Census Tract 248,Staten Island, New York,123,311,134,177,3136,1514,1622,62,27,11,956,29,19,147,97,50